This Is America	Childish Gambino	This Is America
How Long Has This Been Going On?	George Gershwin, Ira Gershwin, Felicia Sanders	The Essential George Gershwin
How Long Has This Been Going On?	Oscar Peterson, Louis Armstrong	Milestones of Jazz Legends - Oscar Peterson & The Greatest Singers, Vol. 7
How Long Has This Been Going On?	Chet Baker	Chet Baker Sings: It Could Happen To You [Original Jazz Classics Remasters] (OJC Remaster)
Toxic	Britney Spears	In The Zone
Tango en Skai	Roland Dyens, Elena Papandreou	Dyens: Guitar Music
Concierto de Aranjuez: II. Adagio	Daniel Barenboim, John Williams, English Chamber Orchestra, James Brown	Rodrigo: Concierto de Aranjuez; Fantasía para un Gentilhombre & Villa-Lobos: Guitar Concerto - Sony Classical Originals
Vals No. 3	John Williams	Barrios - The Great Paraguayan
Vals No. 4	John Williams	Barrios - The Great Paraguayan
Sueño en la floresta	John Williams	Barrios - The Great Paraguayan
La catedral	John Williams	Barrios - The Great Paraguayan
Luci-ah	Lucio Battisti	Il mio canto libero
I Disagree	Poppy	I Disagree
Io ti venderei	Lucio Battisti	La batteria, il contrabbasso, eccetera
Ordinary People	John Legend	Get Lifted
Rose viola	Ghemon	Rose viola
Canary Bay	Indochine	Le Birthday album
Johnny B Goode - 2002 Remaster	Peter Tosh, John Benitez	Mama Africa
The André canta Rolls Royce (Achille Lauro Cover)	The André	Affinità Elettive
Troppo difficile	Paolo Conte	Aguaplano
In Too Deep	Sum 41	All Killer, No Filler
The André canta Orgasmo (Calcutta Cover)	The André	The André canta l'Indie
Bella senz'anima	Riccardo Cocciante	Anima
I Just Want To Make Love To You - Single Version	Etta James	At Last!
Moby Dick	Banco Del Mutuo Soccorso	Banco
One More Kiss, Dear	Vangelis	Blade Runner (Music From The Original Soundtrack)
Vita spericolata	Vasco Rossi	Bollicine (Remastered)
Boys Boys Boys	Sabrina	Boys Boys Boys
Certe notti	Ligabue	Buon compleanno Elvis [Remastered Version]
Carne para la Picadora	La Polla Records	Carne para la Picadora!
Che fantastica storia è la vita	Antonello Venditti	Che Fantastica Storia È La Vita
Quizas, Quizas, Quizas (Perhaps, Perhaps, Perhaps) - Remastered 2003	Nat King Cole	The Classic Singles
Congratulations	MGMT	Congratulations
Chelsea Dagger	The Fratellis	Costello Music
Tout le bonheur du monde	Sinsémilia	Debout les yeux ouverts
L'Empordà	Sopa De Cabra	Dies de Carretera
Harder, Better, Faster, Stronger	Daft Punk	Discovery
Son Of A Preacher Man	Dusty Springfield	Dusty In Memphis
Get It On	T. Rex	Electric Warrior
Cosmic Dancer - Remastered	T. Rex	Electric Warrior [Expanded & Remastered]
Me Falta el Aliento	Estopa	Esencial Estopa
Canto del servo pastore	Fabrizio De André	Fabrizio De André (Indiano)
Un chimico	Fabrizio De André	Fabrizio De André Opere Complete
Am I Your Woman? featuring Ria Currie	Speedometer, Ria Currie	Four Flights Up
I Was a Ye Ye Girl - Orginal Radio Mix	Doing Time	I Was a Ye Ye Girl
Abiura Di Me	Caparezza	Le Dimensioni Del Mio Caos
Volare (Nel Blu di Pinto di Blu)	Gipsy Kings	Mosaïque
I Like Chopin	Gazebo	Portrait
Take Your Mama	Scissor Sisters	Scissor Sisters
Ohio	Crosby, Stills, Nash & Young	So Far
Isn't She Lovely	Stevie Wonder	Songs In The Key Of Life (Reissue)
Cigarettes and Coffee	Otis Redding	The Soul Album
Seven Nation Army	Scott Bradlee's Postmodern Jukebox, Haley Reinhart	Swipe Right For Vintage
Lontano, lontano	Luigi Tenco	Tenco
Habibi	The André	THEMAGOGIA - Tradurre, tradire, trappare
Volare	Domenico Modugno	Volare
Bocca di rosa	Fabrizio De André	Volume 1
Young Folks	Peter Bjorn and John	Writer's Block
Lady Jane - Mono Version	The Rolling Stones	Aftermath
Anni	Paolo Conte	Aguaplano
Azzurro - Remastered	Adriano Celentano	Azzurro (2011 Remaster)
R.I.P. - Requiescant in Pace	Banco Del Mutuo Soccorso	Banco del Mutuo Soccorso
Il giardino del mago	Banco Del Mutuo Soccorso	Banco del Mutuo Soccorso
Sad Song	Lou Reed	Berlin
Paolo, Pa	Banco Del Mutuo Soccorso	I Più Grandi Successi
L'Emozione Non Ha voce (Io Non So Parlar D'Amore)	Adriano Celentano	Io Non So Parlar D'Amore
Non mi rompete	Banco Del Mutuo Soccorso	Io Sono Nato Libero
La mia banda suona il rock	Ivano Fossati	La Mia Banda Suona Il Rock
Take Me Out	Scissor Sisters	Mary
Welcome to Miami (South Beach)	Max Pezzali	Welcome to Miami (South Beach)
There Goes My Miracle	Bruce Springsteen	Western Stars
bad guy (with Justin Bieber)	Billie Eilish, Justin Bieber	bad guy (with Justin Bieber)
Addio a Napoli / Ma come fanno i marinai	Francesco De Gregori, Lucio Dalla	Banana Republic
Piano Sonata No.14 In C Sharp Minor, Op.27 No.2 -"Moonlight": 1. Adagio sostenuto	Ludwig van Beethoven, Daniel Barenboim	Beethoven: Piano Sonatas Nos.8 "Moonlight
Piano Sonata No.8 In C Minor, Op.13 -"Pathétique": 1. Grave - Allegro di molto e con brio	Ludwig van Beethoven, Daniel Barenboim	Beethoven: The Piano Sonatas
Piano Sonata No.8 In C Minor, Op.13 -"Pathétique": 3. Rondo (Allegro)	Ludwig van Beethoven, Daniel Barenboim	Beethoven: The Piano Sonatas
Freed From Desire	Gala	Come Into My Life (The Album)
Lemon Tree	Fools Garden	Dish Of The Day
Jesahel	Delirium	DOLCE ACQUA
Il testamento	Fabrizio De André	Fabrizio De André Opere Complete
Mi Mandi Rose - 2001 Remaster	Mina	Finalmente ho conosciuto il Conte Dracula... (2001 Remastered Version)
Angie	The Rolling Stones	Goats Head Soup (Remastered 2009)
Man in the Mirror	Michael Jackson	HIStory - PAST, PRESENT AND FUTURE - BOOK I
La donna cannone	Francesco De Gregori	La Donna Cannone
Tommaso	Fulminacci	La Vita Veramente
Whitsand Bay	Metronomy	Metronomy Forever
Insecurity	Metronomy	Metronomy Forever
Norman fucking Rockwell	Lana Del Rey	Norman Fucking Rockwell!
Fuck it I love you	Lana Del Rey	Norman Fucking Rockwell!
Doin' Time	Lana Del Rey	Norman Fucking Rockwell!
Pigro	Ivan Graziani	Pigro
Message In A Bottle	The Police	Reggatta De Blanc (Remastered 2003)
Cupido	Dolcenera, The André	Regina Elisabibbi
Volta la carta	Fabrizio De André	Rimini
Ritratti	Pocaroba	Ritratti
X Colpa Di Chi?	Zucchero	SpiritoDiVino
September Second - Live	Michel Petrucciani, Steve Gadd, Anthony Jackson	Trio in Tokyo (Live)
Cantabile - Live	Michel Petrucciani, Steve Gadd, Anthony Jackson	Trio in Tokyo (Live)
Splendida giornata	Vasco Rossi	Vado al massimo (Remastered)
La cattiva strada	Fabrizio De André	Volume 8
Piano Sonata No.8 In C Minor, Op.13 -"Pathétique": 2. Adagio cantabile	Ludwig van Beethoven, Daniel Barenboim	Beethoven: The Piano Sonatas
Tropicana	Gruppo Italiano	Gruppo Italiano
Lugano addio	Ivan Graziani	I Lupi
Vento nel vento	Lucio Battisti	Il mio canto libero
Io vorrei... non vorrei... ma se vuoi	Lucio Battisti	Il mio canto libero
Il mio canto libero	Lucio Battisti	Il mio canto libero
La collina dei ciliegi	Lucio Battisti	Il nostro caro angelo
Ain't No Sunshine	Bill Withers	Just As I Am
29 settembre	Lucio Battisti	Lucio Battisti
Per una lira	Lucio Battisti	Lucio Battisti
Io vivrò senza te	Lucio Battisti	Lucio Battisti Vol. 4
Have You Ever Seen The Rain	Creedence Clearwater Revival	Pendulum (40th Anniversary Edition)
Needles and Pins - 2002 Remaster	Ramones	Road to Ruin (Expanded 2005 Remaster)
Lean on Me	Bill Withers	Still Bill
Innocenti evasioni	Lucio Battisti	Umanamente uomo: il sogno
Comunque bella	Lucio Battisti	Umanamente uomo: il sogno
Ain't No Mountain High Enough	Marvin Gaye, Tammi Terrell	United
Dance Me to the End of Love	Leonard Cohen	Various Positions
L'appuntamento	Ornella Vanoni	Del Mio Meglio
Звезда	Viktor Tsoi	Чёрный альбом
Ai, Dolors	Manel	Els Millors Professors Europeus
A Love Supreme, Pt. III - Pursuance	John Coltrane	A Love Supreme
A Love Supreme, Pt. IV - Psalm	John Coltrane	A Love Supreme
A Love Supreme, Pt. II - Resolution	John Coltrane	A Love Supreme
A Love Supreme, Pt. I – Acknowledgement	John Coltrane	A Love Supreme
Rockstar	Nickelback	All the Right Reasons (Walmart Exclusive Edition)
Old Town Road (feat. Billy Ray Cyrus) - Remix	Lil Nas X, Billy Ray Cyrus	Old Town Road
Across the Universe	Fiona Apple	Pleasantville -Music From The Motion Picture
Baba O'Riley	The Who	Who's Next
That Look You Give That Guy	Eels	Hombre Lobo
Eleanor Put Your Boots On	Franz Ferdinand	You Could Have It So Much Better
Severed Crossed Fingers	St. Vincent	St. Vincent
The Joke	Brandi Carlile	By The Way, I Forgive You
Never Gonna Give You Up	Rick Astley	Whenever You Need Somebody
Violin Concerto in D Major, Op. 61: 1. Allegro ma non troppo	Ludwig van Beethoven, Fritz Kreisler, Anne-Sophie Mutter, Berliner Philharmoniker, Herbert von Karajan	Beethoven: Violin Concerto
I'm on My Way	The Proclaimers	Sunshine On Leith
Jolene	Dolly Parton	Jolene
9 to 5	Dolly Parton	9 To 5 And Odd Jobs
Albachiara	Vasco Rossi	Albachiara
Donne	Zucchero, The Randy Jackson Band	Zucchero & The Randy Jackson Band
Ahi Maria	Rino Gaetano	Resta Vile Maschio, Dove Vai
Sono Il Tuo Sogno Eretico	Caparezza	Il Sogno Eretico
Sapore di sale	Gino Paoli	Basta Chiudere Gli Occhi
Languida	Paolo Conte	Aguaplano
Hesitation	Paolo Conte	Aguaplano
Blue Haways	Paolo Conte	Paris Milonga
Luna Di Marmellata	Paolo Conte	Wonderful
Alle prese con una verde milonga	Paolo Conte	Paris Milonga
Dopo le sei	Paolo Conte	Aguaplano
Hell's Ditch	The Pogues	Hell's Ditch (Expanded)
Alexander Platz	Milva	Noi donne 2
You Showed Me - Remastered	The Turtles	The Battle of the Bands (Deluxe Version)
Mother Of Pearl - Remastered	Roxy Music	The Best Of Roxy Music
Tajabone	Ismaël Lô	Ismael Lo
Summer in Siam	The Pogues	Hell's Ditch (Expanded)
All Along the Watchtower	Jimi Hendrix	Electric Ladyland
Like a Rolling Stone - Live at LA Forum, Inglewood, CA - February 1974	Bob Dylan	Before The Flood
All Along the Watchtower - Live at LA Forum, Inglewood, CA - February 1974	Bob Dylan	Before The Flood
It Ain't Me, Babe - Live at LA Forum, Inglewood, CA - February 1974	Bob Dylan	Before The Flood
Lay, Lady, Lay - Live at LA Forum, Inglewood, CA - February 1974	Bob Dylan	Before The Flood
All Along the Watchtower	Bob Dylan	John Wesley Harding
Elisir	Paolo Conte	Zazzarazàz - Uno Spettacolo D'arte Varia (Deluxe)
Via con me	Paolo Conte	Paris Milonga
Redondo Beach	Patti Smith	Horses (Legacy Edition)
Amsterdam	Scott Walker	Scott
A far l'amore comincia tu	Raffaella Carrà	I Miei Successi
Senza fine	Gino Paoli	Gino Paoli
Non l'hai mica capito	Vasco Rossi	Best of Vasco Rossi
Prima di andare via	Neffa	I Molteplici Mondi Di Giovanni, Il Cantante Neffa
La Mia Parte Intollerante	Caparezza	Habemus Capa
Rumore	Raffaella Carrà	I Miei Successi
A far l'amore comincia tu - Remix	Lilian	Summer Hits 2012
Roadrunner	The Modern Lovers	The Modern Lovers
L'ultima luna	Lucio Dalla	Lucio Dalla
Peaches En Regalia	Frank Zappa	Hot Rats
Tiwàyyen	Tinariwen, Kurt Vile, Matt Sweeney	Elwan
Sastanàqqàm	Tinariwen	Elwan
Nànnuflày	Tinariwen, Kurt Vile, Mark Lanegan	Elwan
Toumast Tincha	Tinariwen	Emmaar
Pomeriggio Zenzero	Paolo Conte	Amazing Game - Instrumental Music
La Musica E' Pagana	Paolo Conte	The Platinum Collection
La fisarmonica di stradella	Paolo Conte	Paolo Conte
Chiunque	Paolo Conte	Paolo Conte
Per Te	Paolo Conte	Zazzarazàz - Uno Spettacolo D'arte Varia (Deluxe)
Avanti, Bionda	Paolo Conte	Paolo Conte
Don't Worry About the Government - 2005 Remaster	Talking Heads	Talking Heads '77 (Deluxe Version)
Uh-Oh, Love Comes to Town - 2005 Remaster	Talking Heads	Talking Heads '77 (Deluxe Version)
I'm Not in Love	Fun Lovin' Criminals	Mimosa
The Infanta	The Decemberists	Picaresque
Porpoise Song (Theme from "Head")	The Monkees	Head
Lo zio	Paolo Conte	Appunti Di Viaggio
Hemingway - Live 12 Aprile 1988	Paolo Conte	Concerto live @ rsi (12 aprile 1988)
Hemingway - Live	Paolo Conte	Concerti (Live)
Nord	Paolo Conte	Appunti Di Viaggio
La Frase	Paolo Conte	Appunti Di Viaggio
Dancing	Paolo Conte	Appunti Di Viaggio
Gioco d'azzardo	Paolo Conte	Appunti Di Viaggio
Fuga all'inglese	Paolo Conte	Appunti Di Viaggio
Hemingway	Paolo Conte	Appunti Di Viaggio
Tubthumping	Chumbawamba	Tubthumper
Rolls Royce (feat. Boss Doms & Frenetik&Orang3)	Achille Lauro, Boss Doms, Frenetik&Orang3	Rolls Royce (feat. Boss Doms & Frenetik&Orang3)
Roses Are Red (My Love) - Single Version	Bobby Vinton	The Best Of Bobby Vinton
Aristocratica - 1991 Remaster	Matia Bazar	Aristocratica (1991 Remaster)
Lili Marleen - 1991 Remaster	Matia Bazar	...Berlino ...Parigi ...Londra (1991 Remaster)
Sallimleh Alayh	Fairuz	Mish Kayan Hayek T'Koun
Le Beirut	Fairuz	Maarifti Feek
Nassam Alayna El Hawa	Fairuz	Bent El Hares
Kifak Inta	Fairuz	Fairuz - Modern Favorites
أهواك	Abdel Halim Hafez	عبدالحليم حافظ
Le Bien Et Le Mal	Souad Massi	Deb
Raoui	Souad Massi	Raoui
Ghir Enta	Souad Massi	Deb
El Seka Shemal Fe Shemal	Cairokee	Noaata Beida
Dinosaur	Cairokee	Dinosaur
Portati via	Mina	Bula Bula
I'm Not Down - Remastered	The Clash	London Calling (Remastered)
The Card Cheat - Remastered	The Clash	London Calling (Remastered)
London Calling - Remastered	The Clash	London Calling (Remastered)
Spanish Bombs - Remastered	The Clash	London Calling (Remastered)
MILANO SUSHI & COCA	M¥SS KETA	L'ANGELO DALL'OCCHIALE DA SERA: COL CUORE IN GOLA
LE RAGAZZE DI PORTA VENEZIA REMIX (feat. Elodie, Priestess & Joan Thiele)	M¥SS KETA, Elodie, Priestess, Joan Thiele	PAPRIKA
Speed of Life - 2017 Remaster	David Bowie	Low (2017 Remastered Version)
Joe's Garage	Frank Zappa	Joe's Garage Acts I, II & III
Little Red Rooster	Howlin' Wolf	Howlin' Wolf
Spoonful	Howlin' Wolf	Howlin' Wolf
Smokestack Lightnin'	Howlin' Wolf	Moanin' In The Moonlight
Regiment - 2006 Digital Remaster	Brian Eno, David Byrne	My Life In The Bush Of Ghosts
This Land is Your Land	Woody Guthrie	The Asch Recordings, Vol. 1-4
Closing Time	Leonard Cohen	The Future
Famous Blue Raincoat	Leonard Cohen	Songs Of Love And Hate
Hallelujah	Leonard Cohen	Various Positions
Suzanne	Leonard Cohen	Songs Of Leonard Cohen
Hurricane	Bob Dylan	Desire
Knockin' On Heaven's Door - Remastered	Bob Dylan	Pat Garrett & Billy The Kid [Soundtrack From The Motion Picture) (Remastered]
Hello, I Love You	The Doors	Waiting for the Sun
Misirlou	Dick Dale and his Del-Tones	Greatest Hits 1961 - 1976
Country Honk	The Rolling Stones	Let It Bleed
Love In Vain	The Rolling Stones	Let It Bleed
You Can't Always Get What You Want	The Rolling Stones	Let It Bleed
You Got The Silver	The Rolling Stones	Let It Bleed
Let It Bleed	The Rolling Stones	Let It Bleed
Gimme Shelter	The Rolling Stones	Let It Bleed
All Day and All of the Night	The Kinks	Kinks (Deluxe Edition)
Caroline	The Velvet Underground	Squeeze
Satellite Of Love - 2015 Remastered Demo Version	The Velvet Underground	Loaded: Re-Loaded 45th Anniversary Edition
All Tomorrow's Parties	The Velvet Underground, Nico	The Velvet Underground & Nico 45th Anniversary
There She Goes Again	The Velvet Underground, Nico	The Velvet Underground & Nico 45th Anniversary
Venus In Furs	The Velvet Underground, Nico	The Velvet Underground & Nico 45th Anniversary (Super Deluxe Edition)
Stephanie Says - Original Mix	The Velvet Underground	White Light / White Heat (Super Deluxe)
Oh! Sweet Nuthin' - 2015 Remastered	The Velvet Underground	Loaded: Re-Loaded 45th Anniversary Edition
VCR	The xx	xx
Rock the Casbah - Remastered	The Clash	Combat Rock (Remastered)
Sexy Boy	Air	Moon Safari
All I Need (feat. Beth Hirsch)	Air, Beth Hirsch	Moon Safari
Do You Remember The First Time?	Pulp	His N Hers
Babies	Pulp	His N Hers
Olsen olsen	Sigur Rós	Ágætis byrjun
Ágaetis byrjun	Sigur Rós	Ágætis byrjun
Jóga	Björk	Jóga
Army Of Me	Björk	Post
The Anchor Song	Björk	Debut
Violently Happy	Björk	Debut
Big Time Sensuality	Björk	Debut
Venus As A Boy	Björk	Debut
Twentieth Century Fox - 2017 Remaster	The Doors	The Doors (50th Anniversary Deluxe Edition)
Break on Through (To the Other Side) - 2017 Remaster	The Doors	The Doors (50th Anniversary Deluxe Edition)
E penso a te - Remastered	Mina	Paradiso (Lucio Battisti Songbook)
La chanson de Prévert	Serge Gainsbourg	L'étonnant Serge Gainsbourg
Buonanotte Fiorellino	Inti-Illimani	Viva Italia
Cinema Paradiso "Tema D'amore","Inti-Illimani	Viva Italia	1
El Pueblo Unido Jamás Será Vencido	Inti-Illimani	Viva Italia
Patio Song	Gorky's Zygotic Mynci	Barafundle
It's My Life - 1997 Remaster	Talk Talk	It's My Life
Lover Come Back to Me - 2003 Remastered Version	Billie Holiday	Blue Moon
Lover, Come Back To Me	Billie Holiday	The Complete Verve Studio Master Takes
bad guy	Billie Eilish	WHEN WE ALL FALL ASLEEP, WHERE DO WE GO?
bury a friend	Billie Eilish	WHEN WE ALL FALL ASLEEP, WHERE DO WE GO?
wish you were gay	Billie Eilish	WHEN WE ALL FALL ASLEEP, WHERE DO WE GO?
Sonata in F Minor, K. 466 (L. 118)	Domenico Scarlatti, Vladimir Horowitz	Horowitz: The Celebrated Scarlatti Recordings - Expanded Edition
Suite bergamasque, L.75: 3. Clair de lune	Claude Debussy, Alexis Weissenberg	Debussy: Clair de Lune; Piano Works
Crystalised	The xx	xx
On Hold	The xx	I See You
Angels	The xx	Coexist
I'm On Fire	Bruce Springsteen	Born In The U.S.A.
Dream Baby Dream	Bruce Springsteen	High Hopes
Piano Sonata No.7 In C, K.309: 1. Allegro con spirito	Wolfgang Amadeus Mozart, Maria João Pires	Mozart: Piano Sonatas K.309, K.332 & K.570
Piano Sonata No. 2 in A Major, Op. 2 No. 2: I. Allegro vivace	Ludwig van Beethoven, Glenn Gould	Glenn Gould plays Beethoven: Piano Sonatas Nos. 1-3; 5-10; 12-14; 15-18; 23; 30-32
Les Moulins De Mon Coeur	Michel Legrand	A Jazz Romance: A Night In With Verve
Todos Repiten Lo Mismo	José Antonio Labordeta	Cantar I Callar
Breathe	The Prodigy	The Fat of the Land - Expanded Edition
Vento nel vento	Mina	Paradiso (Lucio Battisti Songbook)
Bobby Brown Goes Down	Frank Zappa	ZAPPAtite - Frank Zappa's Tastiest Tracks
Genova per noi (feat. Mark Harris, Roberto Colombo)	Antonella Ruggiero, Mark Harris, Roberto Colombo	Quando facevo la cantante
Canzone dell’amore perduto (feat. Francesco Buzzurro, Giuseppe Milici)	Antonella Ruggiero, Libera Sinfonietta, Francesco Buzzurro, Giuseppe Milici	Quando facevo la cantante
Crêuza de mä (feat. Mark Harris,Balentes)	Antonella Ruggiero, Mark Harris, Balentes	Quando facevo la cantante
Lunedì cinema	Stadio	12000 lune
Stasera... Che Sera! - 1991 - Remaster;	Matia Bazar	Matia Bazar 1 (1991 Remaster)
Tango Nel Fango - 1991 Remaster	Matia Bazar	Tango (1991 - Remaster)
Palestina - 1991 Remaster	Matia Bazar	Tango (1991 - Remaster)
Tu O La Sencillez - Remastered	Matia Bazar	Fantasia: Best & Rarities
C'è Tutto Un Mondo Intorno - Remastered	Matia Bazar	Fantasia: Best & Rarities
Per Un'Ora D'Amore - 1991 - Remaster;	Matia Bazar	Matia Bazar 1 (1991 Remaster)
Vacanze Romane - Remaster 1998	Matia Bazar	Collezione Italiana
Brivido Caldo - Live	Matia Bazar	Matia Bazar 40th Anniversary Celebration (Live)
Tu Semplicità - 2007 Remaster	Matia Bazar	Essential (1998 Remaster)
Replica	Oneohtrix Point Never	Replica
Cherry Soda	Stereo Cube	A Scoob Odyssey
voice of reason	underscores	skin purifying treatment
Noi - Remaster 1998	Matia Bazar	The Platinum Collection
E Dirsi Ciao - 1998 Remaster	Matia Bazar	Essential (1998 Remaster)
Sólo Tú - Remastered	Matia Bazar	Fantasia: Best & Rarities
Coccodrilli	Samuele Bersani	Samuele Bersani
Tints (feat. Kendrick Lamar)	Anderson .Paak, Kendrick Lamar	Oxnard
Casio	Jungle	For Ever
Annarella	CCCP – Fedeli Alla Linea	Enjoy CCCP (2008 Remastered Edition)
Io Sto Bene	CCCP – Fedeli Alla Linea	Affinità - Divergenze Fra Il Compagno Togliatti E Noi Del Conseguimento Della Maggiore Età (2008 Remastered Edition)
Giulia Mon Amour	Calibro 35	Traditori di Tutti
Bandits on Mars	Calibro 35	S.P.A.C.E.
Indagine Su Un Cittadino Al Di Sopra Di Ogni Sospetto	Calibro 35	Calibro 35
You Don't Have To Say You Love Me - The Afternoon Show, 2012 Mix	Elvis Presley	Prince From Another Planet (Live)
You Don't Have To Say You Love Me	Dusty Springfield	Complete A And B Sides 1963 - 1970
Io Che Non Vivo - 2004 Remaster	Pino Donaggio	Made In Italy
Tender	Blur	13
All That Jazz	Chicago Ensemble (1997)	Chicago The Musical (New Broadway Cast Recording (1997))
All That Jazz	Ute Lemper, Chicago Ensemble (London (1997))	Chicago The Musical (New London Cast Recording (1997))
Préludes, Book 2, L. 123: No. 7: La terrasse des audiences du clair de lune	Claude Debussy, Jean-Efflam Bavouzet	Debussy, C.: Piano Music (Complete), Vol. 1 - Preludes / Les Soirs Illumines Par L'Ardeur Du Charbon
Perfect Day	Harry Nilsson	The Essential Nilsson
Gling Glo	Björk Guðmundsdóttir, Trio Gudmundar Ingólfssonar	Gling-Glo
Dress Up In You	God Help The Girl	God Help The Girl (Original Motion Picture Soundtrack)
Who's Sorry Now	Connie Francis	Gold
Everything Old Is New Again - Live/1977	Peter Allen	It Is Time For Peter Allen (Live)
Feeling Of Jazz	Dianne Reeves, Wynton Marsalis	Magic Hour
After You've Gone	Wynton Marsalis	The Midnight Blues Standard Time Vol. 5
Pack up Your Troubles - 1916	Murray Johnson	Oh! It's A Lovely War (Vol. 1)
Gnossiennes: No. 1. Lent	Erik Satie, Marcel Worms	Satie: Works for Piano
When It's Sleepytime Down South	Wynton Marsalis	Standards & Ballads
Some of These Days	Bobby Darin	That's All
Bye Bye Love	The Everly Brothers	The Very Best of The Everly Brothers
Concerto for Strings in G Major, RV 151, "Alla Rustica": I. Presto	Antonio Vivaldi, Takako Nishizaki, Capella Istropolitana, Stephen Gunzenhauser	Vivaldi: 4 Seasons (The) / Concerto Alla Rustica
Coal Not Dole	Norma Waterson	Voice & Vision
What A Feeling	Irene Cara	What A Feeling
My Sweet Lord	George Harrison	All Things Must Pass (Remastered)
Be My Baby	The Ronettes	Be My Baby: The Very Best of The Ronettes
Digital	Joy Division	The Best Of
I'm In The Mood For Love	Julie London	The Best Of Julie London
Sunshine Day	Osibisa	The Best Of Osibisa
Main Title (Blow-Up)	Herbie Hancock	Blow-Up: Original Motion Picture Soundtrack
Piece of My Heart	Big Brother & The Holding Company, Janis Joplin	Cheap Thrills
I Wished On The Moon	Ella Fitzgerald	The Complete Decca Singles Vol. 4: 1950-1955
Fly Me To The Moon (In Other Words)	Julie London	The End Of The World
Crazy - Single Version	Patsy Cline, The Jordanaires	Gold
Maybe	Janis Joplin	I Got Dem Ol' Kozmic Blues Again Mama!
Don't Let Me Be Misunderstood	Santa Esmeralda	Kill Bill Vol. 1 Original Soundtrack (PA Version)
(You Make Me Feel Like) A Natural Woman	Aretha Franklin	Lady Soul (With Bonus Selections)
Is That All There Is - Remastered 2002	Peggy Lee	Mirrors
Alaska	Maggie Rogers	Now That The Light Is Fading
One Step Beyond	Madness	One Step Beyond
Cry Baby	Janis Joplin	Pearl (Legacy Edition)
Me and Bobby McGee	Janis Joplin	Pearl (Legacy Edition)
Trust Me	Janis Joplin	Pearl (Legacy Edition)
Cry Baby - Alternate Version	Janis Joplin	Pearl (Legacy Edition)
The Morning of Our Lives	Jonathan Richman & The Modern Lovers	Roadrunner: The Beserkley Collection
Somebody to Love	Jefferson Airplane	Surrealistic Pillow
I Believe (When I Fall In Love It Will Be Forever)	Stevie Wonder	Talking Book
Redemption Song	Johnny Cash, Joe Strummer	Unearthed
San Francisco	Foxygen	We Are the 21st Century Ambassadors of Peace & Magic
Always The Sun - Sunny Side Up Mix	The Stranglers	10
Bye Bye Baby	Bay City Rollers	70s 100 Hits
The Mercy Seat	Johnny Cash	American III: Solitary Man
I Say a Little Prayer	Aretha Franklin	Aretha Now
Wrecking Ball	Miley Cyrus	Bangerz (Deluxe Version)
Easy Living	Billie Holiday	Billie Holiday Love Songs
Mr. Sandman	The Chordettes	The Chordettes
Let It Happen	Tame Impala	Currents
The Less I Know The Better	Tame Impala	Currents
Darklands	The Jesus and Mary Chain	Darklands (Expanded Version)
Amandoti	CCCP – Fedeli Alla Linea	Epica Etica Etnica Pathos (2008 Remastered Edition)
Positively 4th Street - Single Version	Bob Dylan	The Essential Bob Dylan
I'll Be Around	Yo La Tengo	Fade
Free Tibet - Vini Vici Remix	Hilight Tribe, Vini Vici	Free Tibet (Vini Vici Remix)
Blue Skies	Ella Fitzgerald, Harry "Sweets" Edison	Get Happy!
Clint Eastwood	Gorillaz	Gorillaz
Musica ricercata: No. 7, Cantabile, molto legato	György Ligeti, Pierre-Laurent Aimard	György Ligeti Edition, Vol. 3
Rinaldo, HWV 7a / Act 2: "Lascia ch'io pianga","George Frideric Handel, Cecilia Bartoli, Academy of Ancient Music, Christopher Hogwood	Handel: Rinaldo (Original 1711 Version)	2
Hunger	Florence + The Machine	High As Hope
I'll Be Your Pilot	Belle & Sebastian	I'll Be Your Pilot
New York City Cops	The Strokes	Is This It
Let's Go To Bed	The Cure	Japanese Whispers
Knights In White Satin - Part 1	Giorgio Moroder	Knights In White Satin
La fine del mondo	Anastasio	La fine del mondo
Feels Like We Only Go Backwards	Tame Impala	Lonerism
Mica Van Gogh	Caparezza	Museica
The Sound Of Someone You Love Who's Going Away And It Doesn't Matter - 2008 Digital Remaster	Penguin Cafe Orchestra	Music From The Penguin Cafe
My Favorite Things	John Coltrane	My Favorite Things (Deluxe Edition)
Rather Be (feat. Jess Glynne)	Clean Bandit, Jess Glynne	New Eyes
My Girl	Madness	One Step Beyond (35th Anniversary)
Vier Stücke für Xylophon: Gassenhauer nach Hans Neusiedler (1536) für Sopran-, Altxylophon, Castagnetten, kleine Trommel, Schellentrommel und Pauken, Musik für Kinder III, Nr. 15, 1952	Gunild Keetman, Carl Orff, Karl Peinkofer Percussion Ensemble	Orff-Schulwerk, Vol. 1: Musica Poetica
Orff: Carmina Burana: Introduction, Fortuna Imperatrix Mundi, No. 1 "O Fortuna" (Chorus)	Carl Orff, Janice Watson, James Bowman, Donald Maxwell, Bournemouth Symphony Chorus, Waynflete Singers, Highcliffe Junior Choir, Bournemouth Symphony Orchestra, David Hill	Orff: Carmina Burana
Orff: Carmina Burana, Pt. 3: "In trutina" (Soprano)	Carl Orff, David Hill, Janice Watson, Bournemouth Symphony Orchestra	Orff: Carmina Burana
Love Is All Around - From "Four Weddings And A Funeral","Wet Wet Wet	Picture This (20th Anniversary Edition)	1
Perpetuum Mobile	Penguin Cafe Orchestra	Preludes, Airs And Yodels (A Penguin Cafe Primer)
Independence Day	David Byrne	Rei Momo
It's All Over Now Baby Blue	Marianne Faithfull	Rich Kid Blues
Big Town Girl	Cameron Avery	Ripe Dreams, Pipe Dreams
Running on Empty	Jackson Browne	Running on Empty
Sina mali, sina deni (Free)	Khadja Nin	Sambolera
Raggamuffin	Selah Sue	Selah Sue
The Cross	Prince	Sign "O" the Times
Time Is My Everything	Ian Brown	Solarized
That's Entertainment	The Jam	Sound Affects
A Message to You Rudy - 2002 Remaster	The Specials	The Specials (2002 Remaster)
Blue Skies	Willie Nelson	Stardust
Ghost Town	The Specials	Stereo-Typical: A's, B's & Rarities
Friday I'm in Love	Yo La Tengo	Stuff Like That There
The Star-Crossed Lovers (aka Pretty Girl)	Duke Ellington	Such Sweet Thunder
I'm Gonna Be (500 Miles)	The Proclaimers	Sunshine On Leith
Africa	TOTO	Toto IV
Nabucco / Act 3: Va, pensiero, sull'ali dorate	Giuseppe Verdi, Orchester der Deutschen Oper Berlin, Giuseppe Sinopoli, Chor der Deutschen Oper Berlin	Verdi: Nabucco
Senza un perchè - Live	BowLand	X Factor 12 - Live Show #3
Week Without You	Miley Cyrus	Younger Now
Blue Moon - Take 9/M	Elvis Presley	Elvis Presley
Our Mutual Friend	The Divine Comedy	Absent Friends
Time Is Running Out	Muse	Absolution
Cracked Actor - 2013 Remaster	David Bowie	Aladdin Sane (2013 Remastered Version)
I Believe	Simian Mobile Disco	Attack Decay Sustain Release
While My Guitar Gently Weeps - Esher Demo	The Beatles	The Beatles
Starlight	Muse	Black Holes and Revelations
Supermassive Black Hole	Muse	Black Holes and Revelations
Wanted 2 Say	Samaris	Black Lights
Boulevard of Broken Dreams	Green Day	Boulevard of Broken Dreams
La voce del silenzio - 2001 Remastered Version	Mina	Canzonissima 1968
Parole parole - 2001 Remastered Version	Mina	Cinquemilaquarantatre (2001 Remastered Version)
Brian Eno	MGMT	Congratulations
Congratulations	MGMT	Congratulations
The Great Gig In The Sky - 2011 Remastered Version	Pink Floyd	The Dark Side Of The Moon [Remastered] (Remastered Version)
Eclipse - 2011 Remastered Version	Pink Floyd	The Dark Side Of The Moon [Remastered] (Remastered Version)
Bar Italia	Pulp	Different Class / Deluxe Edition
Lovesong - Remastered	The Cure	Disintegration (Deluxe Edition)
Crisi metropolitana	Giuni Russo	Energie (Original LP - Remastered Edit. 2012)
Madam Butterfly (Un Bel Di Vedremo)	Malcolm McLaren	Fans
National Express	The Divine Comedy	Fin de Siecle
Like A Friend - Great Expectations Soundtrack	Pulp	Great Expectations
Inbetween Days	The Cure	The Head On The Door
Paradise Circus	Massive Attack	Heligoland
Around the World	Daft Punk	Homework
How Deep Is Your Love?	The Rapture	In The Grace Of Your Love
Le responsable	Jacques Dutronc	L' aventurier
Everybody Loves You When You're Dead	The Stranglers	La Folie
La Folie	The Stranglers	La Folie
Reclame	Baustelle	La moda del lento
I'm Aquarius	Metronomy	Love Letters
Mi sono innamorato di te	Luigi Tenco	Luigi Tenco
Angela	Luigi Tenco	Luigi Tenco - I Miti
One Of These Days - 2011 Remastered Version	Pink Floyd	Meddle (2011 Remastered Version)
Angel	Massive Attack	Mezzanine
Mio fratello è figlio unico	Rino Gaetano	Mio Fratello E' Figlio Unico
Piano Trio In C, K.548: 2. Andante cantabile - Live At Festspielhaus, Baden Baden, Germany / 2005	Wolfgang Amadeus Mozart, Anne-Sophie Mutter, Daniel Müller-Schott, André Previn	Mozart: Piano Trios K. 548, 542 & 502 (Standard Version)
Piano Trio In B Flat, K.502: 2. Larghetto - Live At Festspielhaus, Baden Baden, Germany / 2005	Wolfgang Amadeus Mozart, Anne-Sophie Mutter, Daniel Müller-Schott, André Previn	Mozart: Piano Trios K. 548, 542 & 502 (Standard Version)
Weekend Wars	MGMT	Oracular Spectacular
The Youth	MGMT	Oracular Spectacular
Roxanne - Remastered 2003	The Police	Outlandos D'Amour (Remastered)
I Saved The World Today - Remastered Version	Eurythmics	Peace
23 Minutes in Brussels	Luna	Penthouse
Bonnie and Clyde - Clyde Barrow Version	Luna	Penthouse
Never Understand	The Jesus and Mary Chain	Psychocandy (Expanded Version)
Message In A Bottle - Remastered 2003	The Police	Reggatta De Blanc (Remastered)
Everybody Loves Somebody	Dean Martin	The Reprise Years
Uprising	Muse	The Resistance
Resistance	Muse	The Resistance
Undisclosed Desires	Muse	The Resistance
I Belong to You (+Mon Coeur S'Ouvre a Ta Voix)	Muse	The Resistance
Juxtapozed With U	Super Furry Animals	Rings Around The World
Rip It Up	Orange Juice	Rip It Up
I Can't Help Myself	Orange Juice	Rip It Up
Hammond Song	The Roches	The Roches
Góða tungl	Samaris	Samaris
Loaded - Andy Weatherall Mix	Primal Scream	Screamadelica
Tíbrá	Samaris	Silkidrangar
Race for the Prize - 2017 Remaster	The Flaming Lips	The Soft Bulletin
I Started Something I Couldn't Finish - 2011 Remaster	The Smiths	Strangeways, Here We Come
Sweet Dreams (Are Made of This) - Remastered	Eurythmics	Sweet Dreams (Are Made Of This)
Every Breath You Take - Remastered 2003	The Police	Synchronicity (Remastered)
Drop The Game	Flume, Nick Murphy / Chet Faker	TheSoundYouNeed, Vol. 1
Astronomy Domine (Live) [2011 - Remaster]	Pink Floyd	Ummagumma (2011 Remastered Version)
Another Brick In The Wall, Pt. 2 - 2011 Remastered Version	Pink Floyd	The Wall (Remastered)
Mother - 2011 Remastered Version	Pink Floyd	The Wall (Remastered)
Goodbye Blue Sky - 2011 Remastered Version	Pink Floyd	The Wall (Remastered)
Hey You - 2011 Remastered Version	Pink Floyd	The Wall (Remastered)
Dancing Barefoot	Patti Smith	Wave
Wonderful Life	Black	Wonderful Life
Don't Stand So Close To Me - Remastered 2003	The Police	Zenyatta Mondatta (Remastered)
Agua De Beber	Astrud Gilberto, Antônio Carlos Jobim	The Astrud Gilberto Album
Adore You	Miley Cyrus	Bangerz (Deluxe Version)
Testify	Rage Against The Machine	The Battle Of Los Angeles
Cities In Dust - Single Version	Siouxsie and the Banshees	The Best Of...
At The Chime Of A City Clock	Nick Drake	Bryter Layter
Hazey Jane I	Nick Drake	Bryter Layter
Everyday - Single Version	Buddy Holly	Buddy Holly
Perlas ensangrentadas	Alaska Y Dinarama	Canciones Profanas
Sonata In G Minor For Violin & Piano, L. 140: 1. Allegro vivo	Claude Debussy, David Oistrakh, Frida Bauer	Debussy/Ravel/Ysaÿe: Violin Sonatas/Prokofiev: 5 Mélodies
Sonata In G Minor For Violin & Piano, L. 140: 3. Finale (Très animé)	Claude Debussy, David Oistrakh, Frida Bauer	Debussy/Ravel/Ysaÿe: Violin Sonatas/Prokofiev: 5 Mélodies
Diamond Dogs - 1999 Remaster	David Bowie	Diamond Dogs
I Must Confess - 2012 Remaster	Everything But The Girl	Eden (Deluxe Edition)
Stupid Girl	Garbage	Garbage
Summer in the City - Remastered	The Lovin' Spoonful	Hums Of The Lovin' Spoonful
Autumn Sweater	Yo La Tengo	I Can Hear The Heart Beating As One
Concerto Italien, BWV 971: I. [Untitled]	Johann Sebastian Bach, Alexandre Tharaud	J.S. Bach: Concertos italiens
Spellbound	Siouxsie and the Banshees	Juju
Can't Stand Me Now	The Libertines	The Libertines
Music When The Lights Go Out	The Libertines	The Libertines
Symphony No. 1 in D Major "Titan": Ib. Immer sehr gemächlich	Gustav Mahler, Leonard Bernstein, New York Philharmonic	Mahler: Symphony No. 1 in D Major "Titan" & Adagio from Symphony No. 10 in F-Sharp Minor
Symphony No. 1 in D Major "Titan": IIIb. A tempo. Ziemlich langsam	Gustav Mahler, Leonard Bernstein, New York Philharmonic	Mahler: Symphony No. 1 in D Major "Titan" & Adagio from Symphony No. 10 in F-Sharp Minor
Águas De Março	Antônio Carlos Jobim	Matita Perê
My Girls	Animal Collective	Merriweather Post Pavilion
Give It Up	Angel Olsen	MY WOMAN
Ever Fallen in Love (With Someone You Shouldn't've)?	Buzzcocks	Operators Manual (Buzzcocks Best)
Pretend Pretend Pretend	Paolo Conte	Paris Milonga
Absolute Beginners - 2002 Remaster	David Bowie	Platinum Collection
Renegades Of Funk	Rage Against The Machine	Renegades
I'm Only Sleeping - Remastered 2009	The Beatles	Revolver (Remastered)
Love You To - Remastered 2009	The Beatles	Revolver (Remastered)
Here, There And Everywhere - Remastered 2009	The Beatles	Revolver (Remastered)
Good Day Sunshine - Remastered 2009	The Beatles	Revolver (Remastered)
And Your Bird Can Sing - Remastered 2009	The Beatles	Revolver (Remastered)
For No One - Remastered 2009	The Beatles	Revolver (Remastered)
Hong Kong Garden	Siouxsie and the Banshees	The Scream
Winters Love	Animal Collective	Sung Tongs
Swing Lo Magellan	Dirty Projectors	Swing Lo Magellan
This Is Not a Love Song	Public Image Ltd.	This is What You Want... This Is What You Get
Dry the Rain	The Beta Band	The Three E.P.'s
On The Rooftops	Ennio Morricone	The Untouchables
Vancouver	Véronique Sanson	Vancouver
I Think I'm Paranoid	Garbage	Version 2.0
Over And Over	Hot Chip	The Warning
Amsterdam - 2015 Remaster	David Bowie	Five Years (1969 - 1973)
Cherry-coloured Funk	Cocteau Twins	Heaven Or Las Vegas (Remastered)
You Showed Me	The Lightning Seeds	Jollification / Dizzy Heights
C'è tempo	Ivano Fossati	Lampo Viaggiatore
Whip It	DEVO	Oh No It's Devo / Freedom Of Choice
Castle In The Snow	Kadebostany	Pop Collection
Dancing In The Dark	Hot Chip	Why Make Sense? (Definitive Version)
C'è tempo - Live	Anastasio	X Factor 12 - Live Show #1
Valerie - Live At BBC Radio 1 Live Lounge, London / 2007	Amy Winehouse	Back To Black (Deluxe Edition)
Un ragazzo di strada	I Corvi	Bang Bang
Stop the Cavalry - Radio Edit	Jona Lewie	The Best of Jona Lewie
Crazy - Single Version	Gnarls Barkley	Crazy
When The Lights Go Out	Crybaby	Crybaby
Viaggi organizzati - Live	Lucio Dalla	Dallamericaruso
String Quartet in F Major: II. Assez vif - Très rythmé	Maurice Ravel, Quatuor Ébène	Debussy, Fauré & Ravel: String Quartets
Woman	John Lennon	Double Fantasy Stripped Down
Roads	Portishead	Dummy
Glory Box	Portishead	Dummy
The Look	Metronomy	The English Riviera
The Bay	Metronomy	The English Riviera
Everything Now	Arcade Fire	Everything Now
Velvet Goldmine - 2015 Remaster	David Bowie	Five Years (1969 - 1973)
Wake Up	Arcade Fire	Funeral
Palaces Of Montezuma	Grinderman	Grinderman 2
Please, Please, Please, Let Me Get What I Want - 2011 Remaster	The Smiths	Hatful of Hollow
Imagine - Remastered	John Lennon	Imagine
Jealous Guy - Remastered 2010	John Lennon, The Plastic Ono Band, The Flux Fiddlers	Imagine
All I Need Is Everything	Aztec Camera	Knife (Expanded)
Love Letters	Metronomy	Love Letters
Karma Police	Radiohead	OK Computer
No Surprises	Radiohead	OK Computer
Diamante	Zucchero	Oro Incenso & Birra - Zucchero Sugar Fornaciari
Creep	Radiohead	Pablo Honey
All Mine	Portishead	Portishead
Bigmouth Strikes Again - 2011 Remaster	The Smiths	The Queen Is Dead
Stand By Me - Remastered	John Lennon	Rock 'N' Roll
Dream Baby Dream	Suicide	The Second Album + The First Rehearsal Tapes
Til I Fell in Love with You	Bob Dylan	Time Out Of Mind
Summer Kisses, Winter Tears	Julee Cruise	Until The End Of The World (Music from the Motion Picture Soundtrack)
The More You Ignore Me, the Closer I Get - 2014 Remaster	Morrissey	Vauxhall And I (20th Anniversary Definitive Master)
Viaggi organizzati	Lucio Dalla	Viaggi Organizzati
To Ramona	Bob Dylan	Another Side Of Bob Dylan
Goldberg Variations, BWV 988	Johann Sebastian Bach, Glenn Gould	Bach: Greatest Hits
Sky and Sand	Paul Kalkbrenner	Berlin Calling (The Soundtrack by Paul Kalkbrenner)
On The Road Again	Canned Heat	The Best Of Canned Heat
Going Up The Country	Canned Heat	The Best Of Canned Heat
Black Market	Weather Report	Black Market
Visions of Johanna	Bob Dylan	Blonde On Blonde
Tangled up in Blue	Bob Dylan	Blood On The Tracks
You're a Big Girl Now	Bob Dylan	Blood On The Tracks
Mama, You Been on My Mind - Live at Philharmonic Hall, New York, NY - October 1964	Bob Dylan, Joan Baez	The Bootleg Volume 6: Bob Dylan Live 1964 - Concert At Philharmonic Hall
Je ne t'aime plus	Manu Chao	Clandestino
Play With Fire - Mono Version	The Rolling Stones	The Darjeeling Limited
Why Did You Do It - Remastered	Stretch	Elastique (Remastered)
Sunday Morning	Flo Morrissey	Gentlewoman, Ruby Man
Can't Hold Us (feat. Ray Dalton)	Macklemore & Ryan Lewis, Ray Dalton	The Heist
You're Going To Lose That Girl - Remastered	The Beatles	Help! (Remastered)
Yesterday - Remastered	The Beatles	Help! (Remastered)
Era già tutto previsto	Riccardo Cocciante	I Momenti Dell'Amore
Rectangle	Jacno	Jacno
Let It Be - Remastered 2009	The Beatles	Let It Be (Remastered)
Birthday	The Sugarcubes	Life's Too Good
Rudie Can't Fail - Remastered	The Clash	London Calling (Remastered)
Bella	Jovanotti	Lorenzo 1997 - L'Albero
John Coltrane	Peter Sarstedt	The Lost Album
Make It Bun Dem	Skrillex, Damian Marley	Make It Bun Dem
Chan-Son Egocentrique - Remastered	Franco Battiato	Mondi Lontanissimi (2008 Remastered Edition)
The Killing Moon	Echo & the Bunnymen	Ocean Rain (Expanded & Remastered)
One Day / Reckoning Song (Wankelmut Remix) [Radio Edit]	Asaf Avidan & the Mojos, Wankelmut	One Day / Reckoning Song (Wankelmut Remix) [Radio Edit]
Nice (Nietzsche) Che Dice	Zucchero	Oro Incenso & Birra - Zucchero Sugar Fornaciari
Tough Mama	Bob Dylan	Planet Waves
Forever Young - Slow Version	Bob Dylan	Planet Waves
Forever Young - Fast Version	Bob Dylan	Planet Waves
Invisible Touch	Genesis	The Platinum Collection
Nowhere Man - Remastered	The Beatles	Rubber Soul (Remastered)
Take Ü There (feat. Kiesza)	Jack Ü, Skrillex, Diplo, Kiesza	Skrillex and Diplo present Jack Ü
Heroes and Villains	Brian Wilson	Smile
Welcome to My Life	Simple Plan	Still Not Getting Any
The Caterpillar	The Cure	The Top (Deluxe Edition)
Sunday Morning	No Doubt	Tragic Kingdom
You Don't Know Me	Caetano Veloso	Transa
Insight - 2007 Remaster	Joy Division	Unknown Pleasures
I Follow Rivers	Lykke Li	Wounded Rhymes
YMCA - Original Version 1978	Village People	YMCA
Dear Prudence - Remastered 2009	The Beatles	The Beatles (Remastered)
While My Guitar Gently Weeps - Remastered 2009	The Beatles	The Beatles (Remastered)
I'm So Tired - Remastered 2009	The Beatles	The Beatles (Remastered)
Mother Nature's Son - Remastered 2009	The Beatles	The Beatles (Remastered)
Believe	Cher	Believe
Volare - 2018 Remaster	David Bowie	Loving the Alien (1983 - 1988)
Los Ageless - piano version	St. Vincent	MassEducation
New York - piano version	St. Vincent	MassEducation
Young Lover - piano version	St. Vincent	MassEducation
Pills - piano version	St. Vincent	MassEducation
Ridgetop	Jesse Colin Young	Song for Juli
Inverno	Fabrizio De André	Tutti Morimmo A Stento
La stagione del tuo amore	Fabrizio De André	Volume 1
La canzone di Marinella	Fabrizio De André	Volume 3
Nell'acqua della chiara fontana	Fabrizio De André	Volume 3
Beep Beep Love	Gruppo Sportivo	10 Mistakes
Star Dust	Benny Goodman	All That Jazz, Vol. 22: “From Jazz to Swing” – Benny Goodman, Vol. 1 (2014 Digital Remaster)
Hey Girl	Gruppo Sportivo	Back to 78
Beautiful Ones	Suede	The Best Of
Lazarus	David Bowie	Blackstar
The Only Living Boy in New York	Simon & Garfunkel	Bridge Over Troubled Water
Alone Together	Chet Baker	Chet [Keepnews Collection]
Sonata In G Minor For Violin & Piano, L. 140: 3. Finale (Très animé)	Claude Debussy, David Oistrakh, Frida Bauer	Debussy/Ravel/Ysaÿe: Violin Sonatas/Prokofiev: 5 Mélodies
Mile End	Pulp	Different Class / Deluxe Edition
Star Dust	Artie Shaw	The Essential Artie Shaw
So Am I	George Gershwin, Ira Gershwin	Gershwin Plays Gershwin: The Piano Rolls
Goldfinger - Main Title	Shirley Bassey	Goldfinger (Original Motion Picture Soundtrack / Expanded Edition)
Symphony No.5 In C Sharp Minor: 4. Adagietto (Sehr langsam)	Gustav Mahler, Berliner Philharmoniker, Herbert von Karajan	Herbert von Karajan - Adagio
The Air That I Breathe - 2008 Remaster	The Hollies	Hollies
Bang Bang (My Baby Shot Me Down)	Nancy Sinatra	How Does That Grab You?
Wasting My Young Years	London Grammar	If You Wait (Deluxe Version)
Just Like Heaven	The Cure	Kiss Me, Kiss Me, Kiss Me
Here's To You	Joan Baez	The Life Aquatic With Steve Zissou
Pardon My Freedom	!!!	Louden Up Now
The Man Who Sold The World - 2015 Remastered Version	David Bowie	The Man Who Sold The World (2015 Remastered Version)
Rhapsody in Blue	George Gershwin, Gary Graffman, Zubin Mehta, New York Philharmonic	Manhattan
Someone To Watch Over Me	George Gershwin, Zubin Mehta, New York Philharmonic	Manhattan
Mine	George Gershwin, Zubin Mehta, New York Philharmonic	Manhattan
He Loves And She Loves	George Gershwin, Zubin Mehta, New York Philharmonic	Manhattan
Love Is Here To Stay	George Gershwin, Zubin Mehta, New York Philharmonic	Manhattan
Embraceable You	George Gershwin, Zubin Mehta, New York Philharmonic	Manhattan
He Loves And She Loves	George Gershwin, Zubin Mehta, New York Philharmonic	Manhattan
Savior	St. Vincent	MASSEDUCTION
New York - Live At Austin City Limits	St. Vincent	New York (Live At Austin City Limits)
Plutonian Nights	Sun Ra	The Nubians of Plutonia
One Thing Left to Try - Matthew Dear Remix	MGMT, Matthew Dear	One Thing Left to Try (Matthew Dear Remix)
Electricity - 2003 Digital Remaster	Orchestral Manoeuvres In The Dark	Orchestral Manoeuvres In The Dark
J'ai demandé à la lune	Indochine	Paradize
Relax - 7" Mix	Frankie Goes To Hollywood	Relax
In Cold Blood (feat. Pusha T)	alt-J	RELAXER
Gentle on My Mind	Dean Martin	The Reprise Years
Movin' on Up	Primal Scream	Screamadelica
Fly Me To The Moon (In Other Words)	Frank Sinatra, Count Basie	Sinatra/Basie: The Complete Reprise Studio Recordings
Slow Slow Disco	St. Vincent	Slow Slow Disco
Daddy's Car	Eno • Hyde	Someday World
Santeria	Sublime	Sublime
Animal Nitrate	Suede	Suede (Remastered) - Deluxe Edition
Bang Bang	Jessie J, Ariana Grande, Nicki Minaj	Sweet Talker (Deluxe Version)
She's A Rainbow - Full Version / With Intro	The Rolling Stones	Through The Past, Darkly (Big Hits Vol. 2)
Suzanne	Nina Simone	To Love Somebody (Expanded Edition)
Strangers In The Night	Frank Sinatra	Ultimate Sinatra
Sunday Morning	The Velvet Underground, Nico	The Velvet Underground & Nico 45th Anniversary (Super Deluxe Edition)
All Tomorrow's Parties	The Velvet Underground, Nico	The Velvet Underground & Nico 45th Anniversary (Super Deluxe Edition)
There She Goes Again	The Velvet Underground, Nico	The Velvet Underground & Nico 45th Anniversary (Super Deluxe Edition)
San Jose	Frankie Goes To Hollywood	Welcome To The Pleasuredome
Via Paolo Fabbri 43 - Remaster 1996	Francesco Guccini	70 x 70
One	U2	Achtung Baby
Tessellate	alt-J	An Awesome Wave
Breezeblocks	alt-J	An Awesome Wave
Camouflage	Stan Ridgway	The Big Heat
Bridge Over Troubled Water	Simon & Garfunkel	Bridge Over Troubled Water
The Boxer	Simon & Garfunkel	Bridge Over Troubled Water
Bye Bye Love - Live at Memorial Auditorium, Burlington, VT - October 1968	Simon & Garfunkel	Bridge Over Troubled Water
The Sound of Silence	Simon & Garfunkel	The Collection
Good Old-Fashioned Lover Boy - Remastered 2011	Queen	A Day At The Races (Deluxe Remastered Version)
Fields Of Gold	Sting	Fields Of Gold - The Best Of Sting 1984 - 1994
Englishman In New York	Sting	Fields Of Gold - The Best Of Sting 1984 - 1994
Moon Over Bourbon Street	Sting	Fields Of Gold - The Best Of Sting 1984 - 1994
Play The Game - Remastered 2011	Queen	The Game (Deluxe Remastered Version)
Save Me - Remastered 2011	Queen	The Game (Deluxe Remastered Version)
The Sound of Silence	Simon & Garfunkel	The Graduate
Radio Ga Ga - Remastered	Queen	Greatest Hits II
With Or Without You - Remastered	U2	The Joshua Tree (Deluxe Edition Remastered)
Brennisteinn	Sigur Rós	Kveikur
Ísjaki	Sigur Rós	Kveikur
Starman	Seu Jorge	The Life Aquatic With Steve Zissou
Rebel Rebel	Seu Jorge	The Life Aquatic With Steve Zissou
Life On Mars?	Seu Jorge	The Life Aquatic With Steve Zissou
Into the Mystic - 2013 Remaster	Van Morrison	Moondance
Hold On	Tom Waits	Mule Variations
Scarborough Fair / Canticle	Simon & Garfunkel	Parsley, Sage, Rosemary And Thyme
Rimmel	Francesco De Gregori	Rimmel
Pezzi di vetro	Francesco De Gregori	Rimmel
Rockabye (feat. Sean Paul & Anne-Marie)	Clean Bandit, Sean Paul, Anne-Marie	Rockabye (feat. Sean Paul & Anne-Marie)
Killer Queen - Remastered 2011	Queen	Sheer Heart Attack (2011 Remaster)
Para Machuchar Meu Coracao	Stan Getz, João Gilberto, Antônio Carlos Jobim	Stan Getz: The Bossa Nova Albums
Só Danço Samba	Stan Getz, João Gilberto, Antônio Carlos Jobim	Stan Getz: The Bossa Nova Albums
Glósóli	Sigur Rós	Takk...
Hoppípolla	Sigur Rós	Takk...
Left Hand Free	alt-J	This Is All Yours
Svefn-g-englar	Sigur Rós	Ágætis Byrjun
Avalon	Sigur Rós	Ágætis byrjun
Untitled #1 (Vaka)	Sigur Rós	( )
Untitled #3 (Samskeyti)	Sigur Rós	( )
Untitled #4 (Njósnavélin)	Sigur Rós	( )
Song to the Siren - Take 7	Tim Buckley	Works In Progress
I'm In The Mood For Love	Bryan Ferry	As Time Goes By
Back To Black	Amy Winehouse	Back To Black
Love Is A Losing Game	Amy Winehouse	Back To Black
Tears Dry On Their Own	Amy Winehouse	Back To Black
Hot Mallets - 2002 Remastered	Lionel Hampton, Dizzy Gillespie	Bebop Professor (Bluebird's Best Series)
Trinity - da "Lo chiamavano Trinità","Annibale	The Best - Vol. 1 - Bud Spencer & Terence Hill	1
Proud Mary	Ike & Tina Turner	Best Of / Proud Mary
Summertime Blues	Eddie Cochran	The Best Of Eddie Cochran
Nothing But The Soul	Horace Silver	Bottle Rocket Short Film Soundtrack
So Far Away - Full Version	Dire Straits	Brothers In Arms (Remastered)
Your Latest Trick	Dire Straits	Brothers In Arms (Remastered)
Why Worry?	Dire Straits	Brothers In Arms (Remastered)
Ride Across The River	Dire Straits	Brothers In Arms (Remastered)
The Man's Too Strong	Dire Straits	Brothers In Arms (Remastered)
One World	Dire Straits	Brothers In Arms (Remastered)
Brothers In Arms	Dire Straits	Brothers In Arms (Remastered)
Cantaloupe Island	Herbie Hancock	Cantaloupe Island
Never Let Me Go	Florence + The Machine	Ceremonials (Original Deluxe Version)
Dream A Little Dream Of Me	Ella Fitzgerald, Louis Armstrong	Classic
You Don't Have To Say You Love Me	Dusty Springfield	Classic Dusty Springfield - The Universal Masters Collection
Take Five - Instrumental	Dave Brubeck	Columbia Jazz Profile
Carry On	Crosby, Stills, Nash & Young	Deja Vu
Helpless	Crosby, Stills, Nash & Young	Deja Vu
Woodstock	Crosby, Stills, Nash & Young	Deja Vu
Deja Vu	Crosby, Stills, Nash & Young	Deja Vu
Country Girl: A. Whiskey Boot Hill. B. Down, Down, Down. C. "Country Girl" (I Think You're Pretty)	Crosby, Stills, Nash & Young	Deja Vu
Oh, Sister	Bob Dylan	Desire
Joey	Bob Dylan	Desire
Black Diamond Bay	Bob Dylan	Desire
Down To The Waterline	Dire Straits	Dire Straits (Remastered)
Wild West End	Dire Straits	Dire Straits (Remastered)
In A Sentimental Mood	Duke Ellington, John Coltrane	Duke Ellington & John Coltrane
La Vie en rose	Édith Piaf	Edith Piaf - The Best Of
Marea Baja	Ken Griffin	El Organo Melodico De
Quelli Che ... Aspettano	Enzo Jannacci	El portava i scarp del tennis
Cheek To Cheek	Ella Fitzgerald, Louis Armstrong	Ella & Louis (Classics International Version)
Needle In The Hay	Elliott Smith	Elliott Smith
Suspicious Minds	Elvis Presley	Elvis 75 - Good Rockin' Tonight
Fever	Elvis Presley	Elvis Presley Sings the Great American Songbook
Mario - Live	Enzo Jannacci	Enzo Jannacci
Always on My Mind - Remastered	Elvis Presley	The Essential Elvis Presley
Summertime	George Gershwin, Ira Gershwin, DuBose Heyward, Dorothy Heyward, Billie Holiday	The Essential George Gershwin
Fear Is A Man's Best Friend	John Cale	Fear
Your Love (Once Upon A Time In The West) - From "C'era Una Volta Il West","Ennio Morricone, Dulce Pontes	Focus	1
Rhapsody in Blue	George Gershwin	Gershwin Plays Gershwin: The Piano Rolls
Crystal	New Order	Get Ready
Naima	John Coltrane	Giant Steps (Deluxe Edition)
Mad About The Boy	Dinah Washington	Gold
Kaw-Liga - Original	Hank Williams	Hank Williams Selected Hits Vol. 2
In the End	Linkin Park	Hybrid Theory (Bonus Edition)
Superstar	Sonic Youth	If I Were A Carpenter
Stardust	Lester Young, Oscar Peterson Trio	Jazz Saxophone Masters
Last Tango in Paris, Pt. 1	Gato Barbieri	Last Tango in Paris (Original Motion Picture Soundtrack)
Last Tango in Paris, Pt. 2	Gato Barbieri	Last Tango in Paris (Original Motion Picture Soundtrack)
C'Era Una Volta In America - Tema Di Deborah / Amapola	Ennio Morricone	Le Colonne Sonore Dei Film Di Sergio Leone
Quelqu'un M'a Dit	Carla Bruni	Learn French Thru Music
I Can't Get Started	Lester Young, Oscar Peterson Trio	Lester Young With The Oscar Peterson Trio (Originals International Version)
Almost Like Being In Love	Lester Young, Oscar Peterson Trio	Lester Young With The Oscar Peterson Trio (Originals International Version)
There Will Never Be Another You	Lester Young, Oscar Peterson Trio	Lester Young With The Oscar Peterson Trio (Originals International Version)
Stardust	Lester Young, Oscar Peterson Trio	Lester Young With The Oscar Peterson Trio (Originals International Version)
The Way I Feel Inside	The Zombies	The Life Aquatic With Steve Zissou
Who Loves The Sun	The Velvet Underground	Loaded: The Fully Loaded Edition
Dream A Little Dream Of Me	Ella Fitzgerald, Louis Armstrong	Louis - The Best Of Louis Armstrong
Autumn Leaves	Chet Baker	My Funny Valentine: The Best Of Chet Baker
Time of the Season	The Zombies	Odessey and Oracle
Lady Day	Lou Reed	Perfect Day
Quelli che...	Enzo Jannacci	Quelli che...
3 Gymnopédies: Gymnopedie No. 1	Erik Satie, Klara Kormendi	Satie: Piano Works (Selection)
Last Tango (Theme From Last Tango In Paris)	Gato Barbieri	The Shadow Of The Cat
Life Is Strange	T. Rex	Tanx
Wild World	Yusuf / Cat Stevens	Tea for the Tillerman (Deluxe Edition)
River Deep - Mountain High	Ike & Tina Turner	Tina!
Vicious	Lou Reed	Transformer
Perfect Day	Lou Reed	Transformer
Walk On the Wild Side	Lou Reed	Transformer
Mes épaules	Albin de la Simone	Un homme
Moi moi	Albin de la Simone, Emilíana Torrini	Un homme
We'll Meet Again	Vera Lynn	Vera Lynn
Tous les garçons et les filles - Slow	Françoise Hardy	The Vogue Years
Cry Me A River	Dinah Washington	What A Diff'rence A Day Makes!
Buona Sera - Remastered	Louis Prima	Wild, Cool & Swingin'
Medley: Just A Gigolo/I Ain't Got Nobody - Remastered	Louis Prima, The Witnesses	Wild, Cool & Swingin'
Three Steps To Heaven	Eddie Cochran	The Best Of Eddie Cochran
(Nothing But) Flowers - 2003 Remaster	Talking Heads	The Best of Talking Heads
Born In The U.S.A.	Bruce Springsteen	Born In The U.S.A.
Glory Days	Bruce Springsteen	Born In The U.S.A.
Dancing In The Dark	Bruce Springsteen	Born In The U.S.A.
Thunder Road	Bruce Springsteen	Born To Run
Born to Run	Bruce Springsteen	Born To Run
Fire In The Hole	Steely Dan	Can't Buy A Thrill
Da sola / In the night (feat. Tommaso Paradiso e Elisa)	Takagi & Ketra	Da sola / In the night (feat. Tommaso Paradiso e Elisa)
Badlands	Bruce Springsteen	Darkness On the Edge of Town
I Was Made For Lovin' You	KISS	Dynasty
Blue (Da Ba Dee)	Eiffel 65	Europop
Anything Could Happen	Ellie Goulding	Halcyon Days
Like a Rolling Stone	Bob Dylan	Highway 61 Revisited
Ballad of a Thin Man	Bob Dylan	Highway 61 Revisited
I Don't Feel Like Dancin' - Radio Edit	Scissor Sisters	I Don't Feel Like Dancin'
The Lovecats	The Cure	Japanese Whispers
La Camisa Negra	Juanes	Mi Sangre
What I've Done	Linkin Park	Minutes to Midnight
Giotto Beat	Caparezza	Museica
Notorious	Duran Duran	Notorious
We Are Detective	Thompson Twins	Platinum & Gold Collection
Pressure Off (feat. Janelle Monáe and Nile Rodgers)	Duran Duran, Janelle Monáe, Nile Rodgers	Pressure Off (feat. Janelle Monáe and Nile Rodgers)
Brass in Pocket - 2006 Remaster	Pretenders	Pretenders [Expanded & Remastered]
Lieutenant Kijé, Op. 60: II. Romance	Sergei Prokofiev, Royal Scottish National Orchestra, Neeme Järvi	Prokofiev: Lieutenant Kije Suite / Andante / Osenneye / the Tale of the Stone Flower (Excerpts)
Il mondo non finisce mai	Brusco, Roy Paci	Quattroemezzo
Papaoutai	Stromae	racine carrée
tous les mêmes	Stromae	racine carrée
Formidable	Stromae	racine carrée
Instant Crush	Daft Punk, Julian Casablancas	Random Access Memories
Get Lucky	Daft Punk, Pharrell Williams, Nile Rodgers	Random Access Memories
Hungry Heart	Bruce Springsteen	The River
If There Is Something	Roxy Music	Roxy Music (Remastered)
Personal Jesus - Single Version	Depeche Mode	The Singles 86-98
Hungry Like the Wolf	Duran Duran	Singles Box '81 - '85
Stardust	MIKA, Chiara	Songbook Vol. 1
Just Can't Get Enough	Depeche Mode	Speak And Spell (Deluxe)
Changing of the Guards	Bob Dylan	Street-Legal
Baby, Stop Crying	Bob Dylan	Street-Legal
Fire In Cairo	The Cure	Three Imaginary Boys
Pinball Wizard	The Who	Tommy (Remastered 2013 Super Deluxe Edition)
Temptation	New Order	TOTAL
You Make Me Feel (Mighty Real)	Jimmy Somerville	The Very Best Of Jimmy Somerville, Bronski Beat & The Communards
Baba O'Riley	The Who	Who's Next (Deluxe Edition)
Tu non mi basti mai	Lucio Dalla	Canzoni
Disperato erotico stomp	Lucio Dalla	Come E' Profondo Il Mare
The End	The Doors	The Doors
Shine On You Crazy Diamond, Pts. 6-9 - 2011 Remastered Version	Pink Floyd	Wish You Were Here [Remastered] (Remastered Version)
She Blinded Me With Science - Extended Version	Thomas Dolby	12x12 Original Remixes
Waiting Room	Fugazi	13 Songs
Attica Blues	Archie Shepp	Attica Blues
Burning Down the House	Talking Heads	Burning Down the House / I Get Wild / Wild Gravity (45 Version)
List Of People (To Try And Forget About)	Tame Impala	Currents B-Sides & Remixes
Space Oddity - 2015 Remaster	David Bowie	David Bowie (aka Space Oddity) [2015 Remaster]
Delicious	Daniel Powter	Delicious
Rebel Rebel - 2016 Remaster	David Bowie	Diamond Dogs (2016 Remastered Version)
Down To Earth	Flight Facilities	Down To Earth
Alone Again Or - 2015 Remastered Version	Love	Forever Changes (2015 Remastered Version)
A Mi Manera (Comme D'Habitude)	Gipsy Kings	Gipsy Kings
Feel Alright	Poolside	Heat
Young Lady, You're Scaring Me	Ron Gallo	Heavy Meta
Heroes - 2017 Remaster	David Bowie	"Heroes" (2017 Remastered Version)
Gronlandic Edit	of Montreal	Hissing Fauna, Are You The Destroyer?
Life on Mars? - 2015 Remaster	David Bowie	Hunky Dory (2015 Remastered Version)
I Love You But I'm Lost	Tears For Fears	I Love You But I'm Lost
I Wish You Lonely	Morrissey	I Wish You Lonely
I'm So Tired	Fugazi	Instrument Soundtrack
Back on the Chain Gang - 2007 Remaster	Pretenders	Learning To Crawl [Expanded and Remastered]
Leila - Poolside Remix	Miami Horror, Poolside	Leila (Poolside Remix)
China Girl - 1999 Remaster	David Bowie	Let's Dance (1999 Remaster)
Let's Dance - 1999 Remaster	David Bowie	Let's Dance (1999 Remaster)
Cat People (Putting out Fire) - 1999 Remaster	David Bowie	Let's Dance (1999 Remaster)
What's That Perfume That You Wear?	Jens Lekman	Life Will See You Now
Hand It Over	MGMT	Little Dark Age
Look Back in Anger - 2017 Remaster	David Bowie	Lodger (2017 Remastered Version)
Sound and Vision - 2017 Remaster	David Bowie	Low (2017 Remastered Version)
Now, Now	St. Vincent	Marry Me
Your Lips Are Red	St. Vincent	Marry Me
Paris Is Burning	St. Vincent	Marry Me
All My Stars Aligned	St. Vincent	Marry Me
Live Is Life	Opus	Millennium Edition
Indian Summer	The Doors	Morrison Hotel
Où va le monde	La Femme	Mystère
Water Fountain	Tune-Yards	nikki nack
No Roots	Alice Merton	No Roots
Overnight	Parcels	Overnight
Losing All Sense	Grizzly Bear	Painted Ruins
Friday on My Mind - 2015 Remaster	David Bowie	PinUps (2015 Remastered Version)
Look Back in Anger - 1998 Remaster	David Bowie	Platinum Collection
Born Under Punches (The Heat Goes On) - 2005 Remaster	Talking Heads	Remain in Light (Deluxe Version)
Starman - 2012 Remaster	David Bowie	The Rise And Fall Of Ziggy Stardust And The Spiders From Mars (2012 Remastered Version)
Ziggy Stardust - 2012 Remaster	David Bowie	The Rise And Fall Of Ziggy Stardust And The Spiders From Mars (2012 Remastered Version)
Schubert: Fantasia in F Minor for Piano 4 hands, Op. 103, D. 940: I. Allegro molto moderato	Franz Schubert, Anne Queffélec, Imogen Cooper	Schubert : Works for piano four hands (APEX)
The Combine	John Maus	Screen Memories
Our Love (U Can Get)	!!!	Shake The Shudder
American Boy	Estelle, Kanye West	Shine
Le Quattro Stagioni: Violin Concerto No. 2 in G Minor, Op. 8, RV 315, "L'estate": III. Presto	Antonio Vivaldi, Dmitry Sinkovsky, La Voce Strumentale	Sinkovsky Plays & Sings Vivaldi
South of the River	Tom Misch	South of the River
Hey Ya!	OutKast	Speakerboxxx/The Love Below
Severed Crossed Fingers	St. Vincent	St. Vincent (Deluxe Edition)
Pieta	St. Vincent	St. Vincent (Deluxe Edition)
Golden Years - 2016 Remaster	David Bowie	Station To Station (2016 Remastered Version)
Itaca	Lucio Dalla	Storie Di Casa Mia
Also sprach Zarathustra, Op.30, TrV 176: Prelude (Sonnenaufgang)	Richard Strauss, Berliner Philharmoniker, Herbert von Karajan	Strauss, R.: Also sprach Zarathustra; Till Eulenspiegel; Don Juan; Salome's Dance Of The Seven Veils
Duo Concertant: 4. Gigue	Igor Stravinsky, Leonidas Kavakos, Peter Nagy	Stravinsky / Bach
Wraith Pinned to the Mist and Other Games	of Montreal	The Sunlandic Twins
Teenage Talk	St. Vincent	Teenage Talk
This Is the Sea - 2004 Remaster	The Waterboys	This Is the Sea (Deluxe Version)
God Only Knows - 1999 Remaster	David Bowie	Tonight (1999 Remaster)
Shuggie	Foxygen	We Are the 21st Century Ambassadors of Peace & Magic
Across the Universe - 2016 Remaster	David Bowie	Young Americans (2016 Remastered Version)
No More Mr. Nice Guy	Alice Cooper	Billion Dollar Babies (Deluxe Reissue)
My Back Pages - Live at Madison Square Garden, New York, NY - October 1992	Bob Dylan, Roger McGuinn, Tom Petty, Neil Young, Eric Clapton, George Harrison	Bob Dylan - 30th Anniversary Concert Celebration [(Deluxe Edition) [Remastered]]
Rêverie	Claude Debussy, Alain Planes	Debussy: Estampes, Pour le piano, Piano Works
I Scare Myself	Thomas Dolby	The Flat Earth
Gloria: In Excelsis Deo	Patti Smith	Horses (Legacy Edition)
i	Kendrick Lamar	i
True Sorry	Ibrahim Maalouf	Illusions
Just A Stranger (feat. Steve Lacy)	Kali Uchis, Steve Lacy	Isolation
I Never Learnt To Share	James Blake	James Blake
Juicy Socks	Cherry Glazerr	Juicy Socks
Ladies and Gentlemen We Are Floating in Space	Spiritualized	Ladies & Gentlemen We Are Floating In Space
Stay up Late - 2005 Remaster	Talking Heads	Little Creatures
Lover's Rock - Remastered	The Clash	London Calling (Remastered)
The Weight - Remastered	The Band	Music From Big Pink (Expanded Edition)
On ne change pas	Céline Dion	On ne change pas
Retrograde	James Blake	Overgrown
Peaches	The Presidents Of The United States Of America	The Presidents of The United States of America: Ten Year Super Bonus Special Anniversary Edition
Te Deum	Arvo Pärt, Bavarian Radio Chorus, Max Hanft, Munich Radio Orchestra, Peter Dijkstra	Pärt: Te Deum (Live)
Apply	Glasser	Ring
Five Years - 2012 Remaster	David Bowie	The Rise And Fall Of Ziggy Stardust And The Spiders From Mars (2012 Remastered Version)
It's No Game (Pt. 1) - 2017 Remaster	David Bowie	Scary Monsters (And Super Creeps) [2017 Remastered Version]
Duchess	Scott Walker	Scott 4
Let The Happiness In - Remastered 2003	David Sylvian	Secrets Of The Beehive
Blue Monday - 2016 Remaster	New Order	Singles (Remastered)
Dance For You	Dirty Projectors	Swing Lo Magellan
Everywhere - 2017 Remaster	Fleetwood Mac	Tango In the Night (Deluxe Edition)
Losing You	Solange	True
Mi sono rotto il cazzo	Lo Stato Sociale	Turisti della democrazia
Disorder - 2007 Remaster	Joy Division	Unknown Pleasures
You Rascal You	Hanni El Khatib	Will the Guns Come Out
There She Goes, My Beautiful World	Nick Cave & The Bad Seeds	Abattoir Blues / The Lyre of Orpheus
Blu notte	Paolo Conte	Aguaplano
Midnight's Knock Out	Paolo Conte	Aguaplano
All the Young Dudes	Mott The Hoople	All The Young Dudes (Expanded Edition)
Gioco d'azzardo	Paolo Conte	Appunti Di Viaggio
Symphony No.5 In C Minor, Op.67: IV. Allegro-Presto	Ludwig van Beethoven, Herbert von Karajan, Berliner Philharmoniker	Beethoven: Symphonies Nos. 5 & 7 - Herbert von Karajan, Berliner Philharmoniker
I'm Free Now	Morphine	Cure For Pain
Time - 2011 Remastered Version	Pink Floyd	The Dark Side Of The Moon [Remastered] (Remastered Version)
Making Plans For Nigel	XTC	Drums And Wires
Emotional Rescue - 2009 Re-Mastered Digital Version	The Rolling Stones	Emotional Rescue (2009 Re-Mastered)
You Look Like Rain	Morphine	Good
Black Dog - Remaster	Led Zeppelin	Led Zeppelin IV (Deluxe Edition)
Road to Nowhere - 2005 Remaster	Talking Heads	Little Creatures
Octopus	Syd Barrett	The Madcap Laughs
Masseduction	St. Vincent	MASSEDUCTION
Happy Birthday, Johnny	St. Vincent	MASSEDUCTION
Fear The Future	St. Vincent	MASSEDUCTION
Young Lover	St. Vincent	MASSEDUCTION
In Bloom - Nevermind Version	Nirvana	Nevermind (Deluxe Edition)
Breed	Nirvana	Nevermind (Remastered)
Lithium	Nirvana	Nevermind (Remastered)
Territorial Pissings	Nirvana	Nevermind (Remastered)
Stay Away	Nirvana	Nevermind (Remastered)
On A Plain	Nirvana	Nevermind (Remastered)
Opel	Syd Barrett	Opel
Old Town	Phil Lynott	The Philip Lynott Album
Purple Rain	Prince	Purple Rain
Once in a Lifetime - 2005 Remaster	Talking Heads	Remain in Light (Deluxe Version)
Dear God - Remastered 2001	XTC	Skylarking
Someone Great	LCD Soundsystem	Sound Of Silver
Rattlesnake	St. Vincent	St. Vincent
Digital Witness	St. Vincent	St. Vincent
I Prefer Your Love	St. Vincent	St. Vincent
Prince Johnny	St. Vincent	St. Vincent (Deluxe Edition)
Regret	St. Vincent	St. Vincent (Deluxe Edition)
Brown Sugar	The Rolling Stones	Sticky Fingers (Remastered)
I Wanna Be Your Dog	The Stooges	The Stooges
Start Me Up - 2009 Re-Mastered Digital Version	The Rolling Stones	Tattoo You (2009 Re-Mastered)
Swingin Party - 2008 Remaster	The Replacements	Tim [Expanded Edition]
Yaylalar	Selda Bağcan	Türkülerimiz 2 - Mehmet Emmi
Moon Is Up - Remastered	The Rolling Stones	Voodoo Lounge (Remastered 2009)
Shine On You Crazy Diamond, Pts. 1-5 - 2011 Remastered Version	Pink Floyd	Wish You Were Here [Remastered] (Remastered Version)
Hurt	Johnny Cash	American IV: The Man Comes Around
My Back Pages	Bob Dylan	Another Side Of Bob Dylan
Manic Depression	Jimi Hendrix	Are You Experienced
Concerto for Piano and Orchestra No. 5 in F Minor, BWV 1056: III. Presto - Remastered	Johann Sebastian Bach, Glenn Gould, Vladimir Golschmann, Columbia Symphony Orchestra	Beethoven: Piano Concerto No. 1 in C Major, Op. 15 - Bach: Keyboard Concerto No. 5 in F Minor, BWV 1056 (Gould Remastered)
Clarinet Concerto in B-Flat Major: Andante sostenuto	Gaetano Donizetti, Camerata De Budapest, Laszlo Kovacs	Donizetti: Instrumental Concertos
L'elisir d'amore: Overture (Preludio)	Gaetano Donizetti, Metropolitan Opera Orchestra, James Levine	Donizetti:L'elisir d'amore - Highlights
Workinonit	J Dilla	Donuts
Mr. Tillman	Father John Misty	God's Favorite Customer
Rewind	Kelela	Hallucinogen
Running Up That Hill (A Deal With God)	Kate Bush	Hounds Of Love
Le Coppie	I Cani	Il Sorprendente Album D'Esordio De I Cani
Jokerman	Bob Dylan	Infidels
Life Is So Good	John Denver	John Denver
Lazaretto	Jack White	Lazaretto
Train in Vain - Remastered	The Clash	London Calling (Remastered)
Duke	Cate le Bon	Mug Museum
Police On My Back - Remastered	The Clash	Sandinista! (Remastered)
You Never Can Tell	Chuck Berry	St. Louis to Liverpool
Let Forever Be	The Chemical Brothers	Surrender
Frontline	Kelela	Take Me Apart
LMK	Kelela	Take Me Apart
Criminal	Fiona Apple	Tidal
Two Weeks	Grizzly Bear	Veckatimest
On The Bound	Fiona Apple	When The Pawn...
Paper Bag	Fiona Apple	When The Pawn...
Eleanor Put Your Boots On	Franz Ferdinand	You Could Have It So Much Better
I'll Never Fall in Love Again	Burt Bacharach, Elvis Costello	Austin Powers: The Spy Who Shagged Me Sndtrk
Concerto for Piano and Orchestra No. 5 in F Minor, BWV 1056: II. Largo - Remastered	Johann Sebastian Bach, Glenn Gould, Vladimir Golschmann, Columbia Symphony Orchestra	Beethoven: Piano Concerto No. 1 in C Major, Op. 15 - Bach: Keyboard Concerto No. 5 in F Minor, BWV 1056 (Gould Remastered)
Walk on By	The Stranglers	Black And White
Carolyn's Fingers	Cocteau Twins	Blue Bell Knoll
Observatory Crest	Captain Beefheart & His Magic Band	Blue Jeans And Moonbeams
New York Herald Tribune	Martial Solal	A bout de souffle (Breathless) [Original Soundtrack] [1959]
Brimful of Asha (Norman Cook Remix) (Single Version)	Cornershop	Brimful of Asha
I Hope That I Don't Fall In Love With You	Tom Waits	Closing Time (Remastered)
Johnny and Mary	Placebo	Covers
Cure for Pain	Morphine	Cure For Pain
Digital Witness - Darkside Remix	St. Vincent	Digital Witness (DARKSIDE Remix)
Fast Slow Disco	St. Vincent	Fast Slow Disco
Atomic	Sleeper, Rapino Brothers	Inbetweener - The Best of Sleeper
Mrs. Robinson - Remastered	The Lemonheads	It's A Shame About Ray (Expanded Edition)
Yamasuki	Yamasuki Singers	Le Monde Fabuleux Des Yamasuki
All the Young Dudes	David Bowie	Legacy (The Very Best of David Bowie)
Dig A Pony - Remastered 2009	The Beatles	Let It Be (Remastered)
Tell Me, Momma - Live at Free Trade Hall, Manchester, UK - May 17, 1966	Bob Dylan	Live 1966 "The Royal Albert Hall Concert" The Bootleg Series Vol. 4
Baby, Let Me Follow You Down - Live at Free Trade Hall, Manchester, UK - May 17, 1966	Bob Dylan	Live 1966 "The Royal Albert Hall Concert" The Bootleg Series Vol. 4
One Too Many Mornings - Live at Free Trade Hall, Manchester, UK - May 17, 1966	Bob Dylan	Live 1966 "The Royal Albert Hall Concert" The Bootleg Series Vol. 4
Like a Rolling Stone - Live at Free Trade Hall, Manchester, UK - May 17, 1966	Bob Dylan	Live 1966 "The Royal Albert Hall Concert" The Bootleg Series Vol. 4
Weekend in the Dust	David Byrne, St. Vincent	Love This Giant
Sometimes - Remastered Version	My Bloody Valentine	Loveless
Terrapin	Syd Barrett	The Madcap Laughs
Slow Disco	St. Vincent	MASSEDUCTION
La javanaise	Serge Gainsbourg	N°4
Another Girl, Another Planet - 2008 re-mastered version	The Only Ones	The Only Ones
Lola	The Raincoats	The Raincoats
Rhythm Nation	Janet Jackson	Rhythm Nation
Miss You Much	Janet Jackson	Rhythm Nation
Love Will Never Do (Without You)	Janet Jackson	Rhythm Nation
It's Raining Today	Scott Walker	Scott 3
30 Century Man	Scott Walker	Scott 3
The Old Man's Back Again (Dedicated To The Neo-Stalinist Regime)	Scott Walker	Scott 4
Dilettante	St. Vincent	Strange Mercy
Fare Thee Well, Miss Carousel	Townes Van Zandt	Townes Van Zandt
Year of the Cat	Al Stewart	Year Of The Cat
All the Things You Are	Charlie Parker	All the Things You Are
Yardbird Suite - 2003 Remastered Version	Charlie Parker	And Friends
Générique - BOF "Ascenseur pour l'échafaud","Miles Davis	Ascenseur Pour L'Echafaud	1
Symphony No.5 In C Minor, Op.67: II. Andante con moto	Ludwig van Beethoven, Herbert von Karajan, Berliner Philharmoniker	Beethoven: Symphonies Nos. 5 & 7 - Herbert von Karajan, Berliner Philharmoniker
It Ain't Me, Babe - Live at Philharmonic Hall, New York, NY - October 1964	Bob Dylan, Joan Baez	The Bootleg Volume 6: Bob Dylan Live 1964 - Concert At Philharmonic Hall
Midnight, the Stars and You	Al Bowlly	Britain's First Pop Star - The Best of Al Bowlly
Love Is All	Roger Glover, Ronnie James Dio	The Butterfly Ball and the Grasshopper's Feast
India Song - BOF India Song	Jeanne Moreau	Chanson française
Baker Street	Gerry Rafferty	City To City
The Gypsy (07-29-46)	Charlie Parker	Complete Jazz Series 1945 - 1947
Wind Of Change	Scorpions	Crazy World
Venus As a Boy	Björk	Debut
Like Someone in Love	Björk	Debut
Violently Happy	Björk	Debut
The Anchor Song	Björk	Debut
Heartbeats	The Knife	Deep Cuts
You Take My Breath Away	The Knife	Deep Cuts
What a Wonderful World	Joey Ramone	Don't Worry About Me
Mad World	Tears For Fears	The Hurting
Libertango	Grace Jones	Hôtel Costes
Fuck You	Lily Allen	It's Not Me, It's You
I Love The Sound Of Breaking Glass	Nick Lowe	Jesus of Cool (Reissue)
Modern Love - 1999 Remaster	David Bowie	Let's Dance (1999 Remaster)
The Letter	The Box Tops	The Letter/Neon Rainbow
Night Boat to Cairo	Madness	One Step Beyond...
Gone Daddy Gone	Violent Femmes	Permanent Record: The Very Best Of The Violent Femmes (GH)
La vie en rose	Grace Jones	Portfolio
Tosca / Act 3: "E lucevan le stelle","Giacomo Puccini, José Carreras, Berliner Philharmoniker, Herbert von Karajan	Puccini: Tosca	2
Shout	Tears For Fears	Songs From The Big Chair (Deluxe)
Vier letzte Lieder, TrV 296: 4. Im Abendrot	Richard Strauss, Jessye Norman, Gewandhausorchester Leipzig, Kurt Masur	Strauss, R.: Four Last Songs, etc.
A Lady of a Certain Age	The Divine Comedy	Victory For The Comic Muse
Hunting for Witches	Bloc Party	A Weekend In the City
Here She Comes Now	The Velvet Underground	White Light / White Heat
The Only Living Boy in New York - 2013 Remaster	Everything But The Girl	Worldwide (Deluxe Edition)
Whole Wide World	Wreckless Eric	Wreckless Eric
Do You Realize??	The Flaming Lips	Yoshimi Battles The Pink Robots (U.S. Version)
Satellite Of Love	Lou Reed	Adventureland
Crimson and Clover	Tommy James & The Shondells	Anthology
Bela Lugosi's Dead	Bauhaus	Bauhaus - 1979-1983 Volume One
Violin Concerto In D, Op.61: 1. Allegro ma non troppo	Ludwig van Beethoven, Anne-Sophie Mutter, Berliner Philharmoniker, Herbert von Karajan	Beethoven: Violin Concerto
Idiot Wind	Bob Dylan	Blood On The Tracks
Shelter from the Storm	Bob Dylan	Blood On The Tracks
Hungarian Dance No.5 In G Minor, WoO 1 No. 5	Johannes Brahms, Wiener Philharmoniker, Claudio Abbado	Brahms: 21 Hungarian Dances
Love and Mercy - Remastered	Brian Wilson	Brian Wilson
Cat People (Putting Out Fire)	Giorgio Moroder, David Bowie	Cat People (Soundtrack)
Je ne peux plus dire ''je t'aime''	Jacques Higelin	Champagne pour tout le monde, caviar pour les autres
Nocturne No.2 en Fa-dièse Majeur, Op 15	Frédéric Chopin, Luis Fernando Pérez	Chopin: Nocturnes (Volume 1)
Rise Above	Black Flag	Damaged
TV Party	Black Flag	Damaged
Long Cool Woman (In a Black Dress) - 1999 Remaster	The Hollies	Distant Light (Expanded Edition)
L'anamour	Serge Gainsbourg	Double Best Of - Comme Un Boomerang
IDGAF	Dua Lipa	Dua Lipa (Deluxe)
7 Heure Du Mat	Jacqueline Taieb	The French Mademoiselle
Look At What The Light Did Now	Flo Morrissey	Gentlewoman, Ruby Man
Little Green Bag	George Baker Selection	Golden Years Of Dutch Pop Music
Oblivious	Aztec Camera	High Land, Hard Rain
Maledetta primavera	Loretta Goggi	I Grandi Successi: Loretta Goggi
These Days	St. Vincent	Jesus Saves, I Spend
Crucify Your Mind	Rodríguez	Late Night Tales: Midlake (Sampler)
Somewhere in My Heart	Aztec Camera	Love
Los Ageless	St. Vincent	MASSEDUCTION
New York	St. Vincent	MASSEDUCTION
Sexx Laws	Beck	Midnite Vultures
Mon manège à moi	Étienne Daho	Mon Manège À Moi
Smells Like Teen Spirit	Nirvana	Nevermind (Deluxe Edition)
Come As You Are	Nirvana	Nevermind (Deluxe Edition)
Tainted Love	Soft Cell	Non-Stop Erotic Cabaret
Ain't Got No - I Got Life (From the musical production "Hair") - Remastered	Nina Simone	'Nuff Said
Enola Gay - Remastered	Orchestral Manoeuvres In The Dark	Organisation
Psyche Rock - Malpaso Mix By Fatboy Slim	Pierre Henry, Michel Colombier	Pierre Henry - Métamorphose-Messe pour le temps présent
Ca plane pour moi	Plastic Bertrand	Plastic Bertrand
(I've Had) The Time of My Life - From "Dirty Dancing" Soundtrack	Bill Medley, Jennifer Warnes	Platinum & Gold Collection
I Love Rock 'n' Roll	The Black Jets	ReCovered Hits Volume 2
Il meglio di me	Claver Gold, Rancore	Requiem
Cherry Bomb	The Runaways	The Runaways
Sex & Drugs & Rock & Roll	Ian Dury & The Blockheads	Sex&Drugs&Rock&Roll - The Essential Collection
Jazz Suite No. 2: VI. Waltz 2	Dmitri Shostakovich, Russian State Symphony Orchestra, Dmitry Yablonsky	Shostakovich: Jazz Suites Nos. 1 - 2 / The Bolt / Tahiti Trot
Cruel	St. Vincent	Strange Mercy
Sunny	Bobby Hebb	Sunny
Piano Concerto No. 1 in B-Flat Minor, Op. 23, TH. 55: 1. Allegro non troppo e molto maestoso - Allegro con spirito - Live at Philharmonie, Berlin	Pyotr Ilyich Tchaikovsky, Evgeny Kissin, Berliner Philharmoniker, Herbert von Karajan	Tchaikovsky: Piano Concerto No.1
Even Flow	Pearl Jam	Ten
Alive	Pearl Jam	Ten
Sila	A Tribe Called Red, Tanya Tagaq	Thoroughbreds (Original Motion Picture Soundtrack)
Personal Jesus	Depeche Mode	Violator (Deluxe)
Tainted Love	Gloria Jones	Vixen
Modern Girl	Sleater-Kinney	The Woods
Shocking You	Shocking Blue	3rd Album
Love Sweet Love	Shocking Blue	3rd Album
Touch-A, Touch-A, Touch Me	Susan Sarandon, Tim Curry, Barry Bostwick, Meat Loaf, Richard O'Brien	Absolute Treasures - The Rocky Horror Picture Show Complete Soundtrack From The Original Movie
Venus	Shocking Blue	At Home
Summertime	The Zombies	Begin Here
Bellini: Norma, Act 1: Casta diva (Norma, Chorus)	Vincenzo Bellini, Maria Callas, Orchestra Del Teatro Alla Scala, Milano, Tullio Serafin, Dino Olivieri, Coro Del Teatro Alla Scala Di Milano, Vittore Veneziani	Bellini: Norma (1954 - Serafin) - Callas Remastered
Laisse tomber les filles	France Gall	Best Of
The Beat Goes On - Live At Chez Club, Hollywood/1966/Remix	Buddy Rich Big Band	Big Swing Face (Live)
The Beat Goes On - Live At The Chez Club, Hollywood/1967	Buddy Rich Big Band	Blue Break Beats Vol. 4
Sugarman	David Holmes presents The Free Association	David Holmes presents The Free Association
Monotonie	Ideal	Der Ernst des Lebens
Sour Times	Portishead	Dummy (Non UK Version)
Facciamo un compromesso	Edoardo Bennato	Edoardo Bennato - All the Best
Eleonore	The Bony King of Nowhere	Eleonore
Evening Side - Oneohtrix Point Never Edit	Four Tet, Oneohtrix Point Never	Evening Side (Oneohtrix Point Never Edit)
Quello che non ho	Fabrizio De André	Fabrizio De André (Indiano)
Always See Your Face	Love	Four Sail (Expanded Edition)
Les passantes	Georges Brassens	Georges Brassens N°13
Good Time	Oneohtrix Point Never	Good Time Original Motion Picture Soundtrack
The Universal - 2012 Remaster	Blur	The Great Escape [Special Edition]
Beautiful Tango - Remastered Version	Hindi Zahra	Handmade [New Version - Includes Bonus]
Changes - 2015 Remaster	David Bowie	Hunky Dory (2015 Remastered Version)
In Dreams	Roy Orbison	In Dreams
Everybody's got to learn sometime (orginal demo)	James Warren	Jim's Easy Listening Album
Daydream	Wallace Collection	Laughing Cavalier
Petite Fleur	Sidney Bechet	Les Années Bechet
Driving Away From Home (Jim's Tune)	It's Immaterial	Life's Hard And Then You Die
E Ti Vengo A Cercare	C.S.I.	Linea Gotica
Si Va Via	Jovanotti	Lorenzo 1994
A Love Supreme, Pt. I – Acknowledgement	John Coltrane	A Love Supreme
Il Cielo In Una Stanza	Mike Patton	Mondo Cane
Lujon	Henry Mancini	Mr. Lucky + Mr. Lucky Goes Latin
To You - Remastered	I Am Kloot	Natural History (Deluxe Version Remastered)
Oh No	Andrew Bird	Noble Beast
Mysteries - 1	Beth Gibbons, Rustin Man	Out Of Season
Also Sprach Zarathustra	Deodato	Prelude (CTI Records 40th Anniversary Edition)
The Boy with the Thorn in His Side - 2011 Remaster	The Smiths	The Queen Is Dead
The Court of the Crimson King	King Crimson	Radical Action To Unseat the Hold of Monkey Mind (Live)
Misread	Kings of Convenience	Riot On An Empty Street
Science Fiction/Double Feature	Richard O'Brien	The Rocky Horror Picture Show - Original Soundtrack
Time Warp	Little Nell, Patricia Quinn, Richard O'Brien	The Rocky Horror Picture Show - Original Soundtrack
Sweet Transvestite	Tim Curry	The Rocky Horror Picture Show - Original Soundtrack
Hot Patootie - Bless My Soul	Meat Loaf	The Rocky Horror Picture Show - Original Soundtrack
Runaway	Del Shannon	Runaway: The Very Best Of Del Shannon
Four to the Floor	Starsailor	Silence Is Easy
Il Colonnello	Lucio Dalla	Storie Di Casa Mia
Temptation	New Order	Trainspotting (Original Motion Picture Soundtrack)
In fila per tre	Edoardo Bennato	Un'ora con...
Layla - Acoustic; Live at MTV Unplugged, Bray Film Studios, Windsor, England, UK, 1/16/1992; 2013 Remaster	Eric Clapton	Unplugged (Deluxe Edition)
Let The Sunshine In	Galt MacDermot	Up From The Basement - Unreleased Tracks - Volumes 1 & 2
I Wanna Be Yours	John Cooper Clarke	The Very Best Of
Ain't Necessarily So	Bronski Beat	The Very Best Of Jimmy Somerville, Bronski Beat And The Communards
Good Times - Mono Version	Eric Burdon & the Animals	Winds Of Change (Mono Version)
The Worker	Fischer-Z	Word Salad
Waltz #2 (XO)	Elliott Smith	XO
Come Home	Amatorski	Come Home
Don't Let It Bring You Down - 2009 Remaster	Neil Young	After the Gold Rush (2009 Remaster)
Smalltown Boy	Bronski Beat	The Age Of Consent
My Mistakes Were Made For You	The Last Shadow Puppets	The Age Of The Understatement
All the Young Dudes - David Bowie & Ian Hunter Vocal	Mott The Hoople	All The Young Dudes (Expanded Edition)
Heart Of The Matter	The Libertines	Anthems For Doomed Youth (Deluxe)
Man On The Moon	R.E.M.	Automatic For The People
Suite No. 3 in C Dur, BWV 1009: I. Prelude	Johann Sebastian Bach, Pieter Wispelwey	Bach: Suites for Cello Solo
When Your Lover Has Gone	Ben Webster, Oscar Peterson	Ben Webster Meets Oscar Peterson
Angie - 2015 Remaster	Bert Jansch	Bert Jansch
Spring, Summer, Winter And Fall	Aphrodite's Child	Best Of
Midnight Cowboy	John Barry	Best Of
(Si, Si) Je Suis Un Rock Star	Bill Wyman	Bill Wyman
Moon River(Vocal Audrey Hepburn)	Henry Mancini	Breakfast At Tiffany's (50th Anniversary Edition)
Breakfast At Tiffany's	Henry Mancini	Breakfast At Tiffany's (50th Anniversary Edition)
Love Without Lies	Comet Gain	Broken Record Prayers
Buona Sera - Remastered	Louis Prima	Capitol Collectors Series
<A BOUT DE SOUFFLE> Waltzes, op.34/ No.3 in F major (Waltz No.4) (Chopin)	Frédéric Chopin, Abbey Simon, Piano	CINEMA CLASSICS World of Jean-Luc Godard Vol.1 A BOUT DE SOUFFLE/PIERROT LE FOU
<A BOUT DE SOUFFLE> Clarinet Concerto in A major, K.622 / 2nd mvt: Adagio (Mozart)	Wolfgang Amadeus Mozart, Gerd Starke (clarinet), Württemberg Chamber Orchestra, Jörg Faerber [Conductor]	CINEMA CLASSICS World of Jean-Luc Godard Vol.1 A BOUT DE SOUFFLE/PIERROT LE FOU
<A BOUT DE SOUFFLE> Clarinet Concerto in A major, K.622 / 3rd mvt: Rondo - Allegro (Mozart)	Wolfgang Amadeus Mozart, Gerd Starke (clarinet), Württemberg Chamber Orchestra, Jörg Faerber [Conductor]	CINEMA CLASSICS World of Jean-Luc Godard Vol.1 A BOUT DE SOUFFLE/PIERROT LE FOU
<PIERROT LE FOU> Piano Sonata No.9 in E major, op.14, No.1/ 1. Allegro (Beethoven)	Ludwig van Beethoven, Alfred Brendel	CINEMA CLASSICS World of Jean-Luc Godard Vol.1 A BOUT DE SOUFFLE/PIERROT LE FOU
History Repeating	Propellerheads, Shirley Bassey	Decksandrumsandrockandroll
Pass This On	The Knife	Deep Cuts
Common People	Pulp	Different Class / Deluxe Edition
Somebody Loves Me	Django Reinhardt	Djangologie Vol6 / 1937
Here Comes Your Man	Pixies	Doolittle
I Just Don't Know What to Do with Myself	The White Stripes	Elephant
Giu la testa	Ennio Morricone	Ennio Morricone: Fotogramma per fotogramma, Vol. 1
Come Here	Kath Bloom	Finally
Bela Lugosi's Dead (The Hunger)	Spirital	The Hunger - Horror Movie Themes
Lakmé, Act 1: Dôme épais le jasmin "Flower Duet","Léo Delibes, Carl Davis, Royal Liverpool Philharmonic Orchestra, Janice Watson, Ruby Philogene, The King's Division Normandy Band	I don't like classical music, but I really like this!	1
Someday	The Strokes	Is This It
Don't Stop Me Now - Remastered	Queen	Jazz (2011 Remaster)
The Love Me Or Die	C.W. Stoneking	Jungle Blues
Hungarian Rhapsody No.2 In C Sharp Minor, S.244	Franz Liszt, Berliner Philharmoniker, Herbert von Karajan	Karajan Festival
Killing Me Softly with His Song	Roberta Flack	Killing Me Softly
Land of My Dreams	Anna Domino	L'amour fou
Drivin' on 9	The Breeders	Last Splash
Thème de Camille	Georges Delerue	Le mépris (Original Movie Soundtrack) – EP
Please Don't Lead Me On	The Sheepdogs	Learn & Burn
Liebestraume, S541/R211 : No. 3: Nocturne in A-Flat Major	Franz Liszt, Jenő Jandó	Liszt: Scherzo and March / 3 Liebestraume / Berceuse
Bohemian Rhapsody - Remastered 2011	Queen	A Night At The Opera (2011 Remaster)
I Got It Bad And That Ain't Good	Oscar Peterson Trio	Night Train
Shout To The Top - Full Version	The Style Council	Our Favourite Shop (Deluxe Edition)
Boléro, M. 81	London Symphony Orchestra	Ravel: Boléro - Daphnis et Chloë - Pavane
Reptilia	The Strokes	Room On Fire
Piano Trio No. 2 In E Flat Major, Op. 100, D. 929: II. Andante Con Moto	Stuttgart Piano Trio, Franz Schubert	Schubert: Piano Trios In E Flat Major, D. 929 And D. 897
Jazz Suite No.2: 6. Waltz II	Dmitri Shostakovich, Royal Concertgebouw Orchestra, Riccardo Chailly	Shostakovich: The Jazz Album
Can We Start Again	Tindersticks	Simple Pleasure
Nobody but You	Lou Reed, John Cale	Songs For Drella
Main Title (from "Taxi Driver")	Bernard Herrmann	Taxi Driver
Playground Love (with Gordon Tracks)	Air, Gordon Tracks	The Virgin Suicides (Deluxe Version - 15th Anniversary)
Je suis venu te dire que je m'en vais	Serge Gainsbourg	Vu de l'extérieur
Wagner: Parsifal: Prelude to Act 1	Richard Wagner, Daniel Barenboim, Berliner Philharmoniker	Wagner : Parsifal [Highlights]
Time Is On My Side	Irma Thomas	Wish Someone Would Care
Lisztomania	Phoenix	Wolfgang Amadeus Phoenix
Let The Sunshine In (Reprise) - Remastered 2000	The 5th Dimension	The Age Of Aquarius
Truth (Helios Remix)	Balmorhea	All Is Wild, All Is Silent Remixes
Auff!!	Management	Auff!!
Is It Like Today?	World Party	Bang!
Pile ou face	Corynne CHARBY	Best Of
Make Me Smile (Come up and See Me) - 2014 Remaster	Steve Harley, Steve Harley & Cockney Rebel	The Best Years of Our Lives (Deluxe Version)
California	The Lagoons	California
Californication	Red Hot Chili Peppers	Californication (Deluxe Edition)
À bicyclette	Yves Montand	Chanson française
Nocturne No.1 In B Flat Minor, Op.9 No.1	Frédéric Chopin, Maurizio Pollini	Chopin: Nocturnes
Diabolo menthe	Yves Simon	Diabolo Menthe
Ando Meio Desligado	Os Mutantes	"A Divina Comédia Ou Ando Meio Desligado","1
Sangue latino	Secos & Molhados	Dois Momentos
Carry	Martyn Heyne	Electric Intervals
I Will Survive	Cake	Fashion Nugget
Fisherman's Blues - 2006 Remaster	The Waterboys	Fisherman's Blues
Dance With Me	Adam Green	Garfield
Don't Get Me Wrong - 2007 Remaster	Pretenders	Get Close [Expanded & Remastered]
Misirlou	Dick Dale and his Del-Tones	Guitar Legend: The Very Best Of Dick Dale
Out on the Weekend - 2009 Remaster	Neil Young	Harvest (2009 Remaster)
Tomorrow Is My Turn	Nina Simone	I Put A Spell On You
A Waltz For a Night	Julie Delpy	Julie Delpy
Pregherò (Stand By Me) - Remastered	Adriano Celentano	La Festa (2011 Remaster)
Le Grand sommeil	Étienne Daho	La notte la notte
Bandiera Bianca - Remastered	Franco Battiato	La Voce Del Padrone (2008 Remastered Edition)
L'immensità	Johnny Dorelli	Le Piu' Belle Canzoni
Devant le magasin	José Bartel, Danielle Licari, Christiane Legrand	Les parapluies de Cherbourg (Bande originale remasterisée du film de Jacques Demy)
Devant le garage	José Bartel, Danielle Licari	Les parapluies de Cherbourg (Bande originale remasterisée du film de Jacques Demy)
To Catch a Thief	Lovage, Mike Patton, Jennifer Charles, Nathaniel Merriweather	Lovage: Music to Make Love to Your Old Lady By
Ho capito che ti amo	Luigi Tenco	Luigi Tenco
As Tears Go By	Marianne Faithfull	Marianne Faithfull's Greatest Hits
Message Personnel	Françoise Hardy	Message Personnel
Nothing Else Matters	Metallica	Metallica
Il Cielo In Una Stanza	Mike Patton	Mondo Cane
Lombardia	Mercanti di Liquore	Musica dei poveri
Nothing Really Ends	dEUS	No More Loud Music - The Singles
All Lined Up	Shriekback	Oil and Gold
On And On - Edit	Curtis Harding	On And On (Edit)
Electric Feel	MGMT	Oracular Spectacular
Orgasmo	Calcutta 	Orgasmo
Miss Miss	Benjamin Biolay	Palermo Hollywood
Paris 1919	John Cale	Paris 1919
Long Time	Blondie	Pollinator
Pretty Girl	Clairo	Pretty Girl
Retiens la nuit - BOF "Les Parisiennes","Johnny Hallyday	Retiens La Nuit	1
Dirty Old Town	The Pogues	Rum Sodomy & The Lash (Expanded)
Violin Sonata (Sonatina) in D Major, Op. 137, No. 1, D. 384: II. Andante	Franz Schubert, Julia Fischer, Martin Helmchen	Schubert, F.: Violin and Piano Music (Complete), Vol. 1
Jackie	Scott Walker	Scott 2
Sowing The Seeds Of Love	Tears For Fears	The Seeds Of Love (Remastered with bonus tracks)
Cvalda	Björk	Selma Songs
I've Seen It All	Björk	Selma Songs
New World	Björk	Selma Songs
There Is An End	The Greenhornes, Holly Golightly	Sewed Soles
Nulla in Mundo Pax Sincera - Arr. Edwards/Hirschfelder	Antonio Vivaldi, Jane Edwards, Choir, Geoffrey Lancaster, Gerald Keuneman, Orchestra, Ricky Edwards	Shine - Original Motion Picture Soundtrack
Put Your Head on My Shoulder	Paul Anka	Sings His Favorites
Love Is The Drug	Roxy Music	Siren (Remastered)
New York, I Love You but You're Bringing Me Down	LCD Soundsystem	Sound Of Silver
This Charming Man - 2008 Remaster	The Smiths	The Sound of the Smiths (Deluxe; 2008 Remaster)
Souvenirs, souvenirs	Johnny Hallyday	Souvenirs, Souvenirs
Something For Your M.I.N.D.	Superorganism	Superorganism
Dance Yrself Clean	LCD Soundsystem	This Is Happening
Sere Nere	Tiziano Ferro	TZN -The Best Of Tiziano Ferro (Lo Stadio Tour 2015 Edition)
Don't Kiss Me Goodbye	Ultra Orange, Emmanuelle	Ultra Orange & Emmanuelle
Naufragando	Management	Un incubo stupendo
Architetture Lontane	Paolo Conte	Una Faccia In Prestito
The Day Before You Came	ABBA	The Visitors
Everyday Is Like Sunday - 2011 Remaster	Morrissey	Viva Hate [2011 - Remaster] (2011 Remastered Version)
Suedehead - 2011 Remaster	Morrissey	Viva Hate [2011 - Remaster] (2011 Remastered Version)
Notget	Björk	Vulnicura
La crisi	Bluvertigo	Zero
Perfect	Ed Sheeran	÷ (Deluxe)
Something - Remastered	The Beatles	Abbey Road (Remastered)
Piano Trio "Archduke" in B Flat Major, Op.97: I. Allegro moderato	Bamberg Trio, Ludwig van Beethoven	Beethoven: Piano Trio "Archduke" in B Flat Major Op.97
Go	The Chemical Brothers	Born In The Echoes
Raindrops Keep Fallin' On My Head - From "Butch Cassidy And The Sundance Kid" Soundtrack	B.J. Thomas	Butch Cassidy & The Sundance Kid
Turne dala mé zènt (feat. Charlie Cinelli)	Bepi & The Prismas, Charlie Cinelli	Ca7 (casèt)
Don't Look Back Into The Sun	The Libertines	Don't Look Back Into The Sun
I Gotta Feeling	The Black Eyed Peas	THE E.N.D. (THE ENERGY NEVER DIES) [International Version]
Eternal Flame	The Bangles	The Essential Bangles
Lili Marleen.	Marlene Dietrich	The Essential Marlene Dietrich
Could Have Been Me	The Struts	Everybody Wants
Kiss This	The Struts	Everybody Wants
Summertime	Charlie Parker	The Genius Of Charlie Parker #2: April In Paris
Nathalie	Gilbert Bécaud	Gilbert Becaud (1964-1966) [2011 Remastered] [Deluxe version]
I Follow Rivers - The Magician Remix	Lykke Li, The Magician	I Follow Rivers (The Magician Remix)
Goodnight Moon	Shivaree	I Oughtta Give You A Shot In The Head For Making Me Live In This Dump (International Only)
Alright	Supergrass	I Should Coco
I'm Easy	Keith Carradine	I'm Easy
Sing	Travis	The Invisible Band
Partita No.1 In B Flat Major, BWV 825: Prelude	Johann Sebastian Bach, Rafał Blechacz	Johann Sebastian Bach
Hush	Kula Shaker	Kollected - The Best Of Kula Shaker
Nessuno	Mina	L'oro di Mina
Wir werden sehen - Paul Kalkbrenner Remix	2raumwohnung, Paul Kalkbrenner	Lasso - Remixe
What Is and What Should Never Be - 1990 Remaster	Led Zeppelin	Led Zeppelin II
Two Of Us - Remastered	The Beatles	Let It Be (Remastered)
I Me Mine - Remastered	The Beatles	Let It Be (Remastered)
What Katie Did	The Libertines	The Libertines
Bad Habit	The Kooks	Listen
Hateful - Remastered	The Clash	London Calling (Remastered)
Revolusion	Elliphant	Look Like You Love It
Mad About You	Hooverphonic	The Magnificent Tree
Hit The Road Jack	Ray Charles	Miami Lighthouse for the Blind Presents: Instrumental Magic
Sfogati	Caparezza	Museica
Vladimir Martynov: The Beatitudes	Vladimir Martynov, Kronos Quartet	Music of Vladimir Martynov
Zombie	The Cranberries	No Need To Argue (The Complete Sessions 1994-1995)
Sun of a Gun	Oh Land	Oh Land
Rainbow	Oh Land	Oh Land
Sex on Fire	Kings of Leon	Only By The Night
Porcelain	Moby	Play & Play: B Sides
My Way - 1993 Remastered Version	Sid Vicious	Playlist: New Wave
Tonight We Fly	The Divine Comedy	Promenade
Killing In The Name	Rage Against The Machine	Rage Against The Machine - XX (20th Anniversary Special Edition)
Stolen Dance	Milky Chance	Sadnecessary
L'Unica Cosa	Marta Sui Tubi	Salva Gente
Ashes to Ashes	David Bowie	Scary Monsters
Impromptus, D. 899 (Op. 90): Impromptu No. 3 in G-Flat Major: Andante	Franz Schubert, Murray Perahia	Schubert: Impromptus, D. 899 (Op. 90) & D. 935 (Op. 142)
Duel	Propaganda	A Secret Wish (Deluxe Edition)
Singin' in the Rain	Singin' In The Rain - Original Cast	Singin' in the Rain (Original Cast Recording)
Blue Moon	Billie Holiday	Solitude
White Rabbit - Sucker Punch: Original Motion Picture Soundtrack	Emilíana Torrini	Sucker Punch (Original Motion Picture Soundtrack)
Mykonos	Fleet Foxes	Sun Giant
November Rain	Guns N' Roses	Use Your Illusion I
Don't Look Back in Anger - Remastered	Oasis	(What's The Story) Morning Glory? [Remastered]
All My Loving - Remastered	The Beatles	With The Beatles (Remastered)
Super Sex	Morphine	Yes
Do I Wanna Know?	Arctic Monkeys	AM
Why'd You Only Call Me When You're High?	Arctic Monkeys	AM
Paradise City	Guns N' Roses	Appetite For Destruction
La cosa buffa	Ennio Morricone	Assoluto Morricone Best, Vol. 1
Fibre De Verre	Paris Combo	Attraction
Born To Be Blue	Chet Baker	Baby Breeze
BACH - Suite for Solo Cello No. 1 in G Major BWV1007, "Prelude","Chris Grist	BACH - Suite for Solo Cello No. 1 in G Major BWV1007	1
Dog Days Are Over	Florence + The Machine	Between Two Lungs
The Whistle Song	Frankie Knuckles	Beyond The Mix
The Judge	Twenty One Pilots	Blurryface
Che Cossé l'Amor	Vinicio Capossela	Camera A Sud
It's Always You - Vocal Version	Chet Baker	Chet Baker Sings
But Not For Me - Vocal Version	Chet Baker	Chet Baker Sings
Buena	Morphine	Cure For Pain
Roads	Portishead	Dummy (Non UK Version)
Cantaloupe Island - Remastered 1999 / Rudy Van Gelder Edition	Herbie Hancock	Empyrean Isles (Rudy Van Gelder Edition / Expanded Edition)
Shipbuilding - Remastered in 1998	Robert Wyatt	EPs
La fac de lettres	Jacqueline Taieb	The French Mademoiselle
Chameleon	Herbie Hancock	Head Hunters
Beggin'	Madcon	Here Comes The Weekend
Mr. Brightside	The Killers	Hot Fuss
Somebody Told Me	The Killers	Hot Fuss
Fascinating Rhythm	George Gershwin, Yehudi Menuhin, Stéphane Grappelli, Max Harris	Icon: Menuhin and Grappelli
Little Arithmetics	dEUS	In A Bar, Under The Sea
Io ho in mente te	Equipe 84	Io Ho In Mente Te
Autumn Leaves	Chet Baker	Jazz Moods - Cool
Menuet and Badinerie	Johann Sebastian Bach, James Galway, I Solisti di Zagreb, Boston Pops Orchestra	Je n'aime pas le classique mais ca j'aime bien
Beggin' - 2007 Remaster	Frankie Valli & The Four Seasons	Jersey Beat: The Music Of Frankie Valli and The Four Seasons
Quelli Che Benpensano	Frankie HI-NRG MC	La Morte Dei Miracoli & Diff. Coupling
Are 'Friends' Electric?	Groove Armada	Late Night Tales: Groove Armada
Across The Universe - Remastered	The Beatles	Let It Be (Remastered)
Windmills of Your Mind - Remastered Version	Noel Harrison	Life Is A Dream [Digital Version]
Ready For The Floor	Hot Chip	Made In The Dark
The Dope Show	Marilyn Manson	Mechanical Animals
Couldn't Get It Right	Fun Lovin' Criminals	Mimosa
Amarcord: Amarcord	Nino Rota, Pino Calvi, Studio Orchestra, StudioConductor	Original Music for the Movies of Federico Fellini
Cimitero (Suite): Gigolettes (From "La Danza delle Libellule") / Cadillac / Carlotta's Galop	Nino Rota	Otto e Mezzo
There Is a Light That Never Goes Out - 2011 Remaster	The Smiths	The Queen Is Dead
Within	Daft Punk	Random Access Memories
Can't Take My Eyes off You	Frankie Valli	Solo
Hey Boy Hey Girl	The Chemical Brothers	Surrender
Afrikaan Beat	Bert Kaempfert	A Swingin' Safari (Remastered)
Non sono una signora	Loredana Bertè	Traslocando
December, 1963 (Oh What a Night!)	Frankie Valli & The Four Seasons	Who Loves You
The Rockafeller Skank - Short Edit	Fatboy Slim	You've Come a Long Way Baby (10th Anniversary Edition)
E se domani	Mina	4 anni di successi
Nabucco, Act III: Chorus of the Hebrew Slaves, "Va pensiero, sull'ali dorate","Giuseppe Verdi, London Philharmonic Choir, The London Chorus, David Parry, London Philharmonic Orchestra	The 50 Greatest Pieces of Classical Music	1
WEIGHT OFF	KAYTRANADA, BADBADNOTGOOD	99.9%
Missing - 2013 Remaster	Everything But The Girl	Amplified Heart (Deluxe Edition)
L'amore è tutto qui	Piero Ciampi	Andare Camminare Lavorare
Keyboard Suite No. 1 (Set II) in B-Flat Major, HWV 434: IV. Menuet (arr. W. Kempff for piano)	Wilhelm Kempff, George Frideric Handel, Roberto Cominati	Bach & Handel: Transcriptions for Piano
Symphony No. 1 in C, Op. 21: I. Adagio molto, Allegro con brio	Royal Concertgebouw Orchestra	The Beethoven Complete Symphonies, Vol.1
Love Will Tear Us Apart	Joy Division	The Best Of
Blue Velvet	Bobby Vinton	The Best Of Bobby Vinton
Nuit de folie - Version originale 1988	Début De Soirée	Best of Début de Soirée (Le meilleur des années 80)
On Broadway - Edit	George Benson	The Best Of George Benson
2 Arabesques, L. 66: No. 1 in E Major	Claude Debussy, Michael Korstick	Debussy: Piano Music, Vol. 4
One More Time	Daft Punk	Discovery
Each and Every One - 2012 Remaster	Everything But The Girl	Eden (Deluxe Edition)
It's Now or Never	Elvis Presley	Elvis' Golden Records, Vol. 3
C'est Ma Vie	Adamo	Essential
Cheek to Cheek	Fred Astaire	The Essential Fred Astaire
Amore che vieni, amore che vai	Fabrizio De André	Fabrizio De André Opere Complete
New York, New York	Liza Minnelli	Finest
Occhi	Zucchero	Fly (Italian Version)
Follow Me - Club Mix	Aly-Us	Follow Me
Free Fallin'	Tom Petty	Full Moon Fever
My Friend	Groove Armada	Goodbye Country (Hello Nightclub)
Close To Me	The Cure	The Head On The Door (Remastered)
Human After All - Sebastian Remix	Daft Punk	Human After All (Remixes)
Alone, Together	The Strokes	Is This It
Last Nite	The Strokes	Is This It
Concerto en ré mineur, BWV 974: II. Adagio	Johann Sebastian Bach, Alexandre Tharaud	J.S. Bach: Concertos italiens
La chanson des vieux amants	Jacques Brel	Jacques Brel 67
Kiko and the Lavender Moon	Los Lobos	Kiko
La Bamba	Los Lobos	La Bamba / Charlena (45 Version)
Dakota	Stereophonics	Language.Sex.Violence.Other?
Mozart / Arr Grieg: Piano Sonata No. 16 in C Major, K. 545: I. Allegro (Arr. Grieg for 2 Pianos) [Live]	Wolfgang Amadeus Mozart, Martha Argerich	Live from the Lugano Festival 2005
Cancion del Mariachi	Antonio Banderas, Los Lobos	Mexico & Mariachis: Music From And Inspired By Robert Rodriguez's El Mariachi Trilogy
Symphony No.41 In C, K.551 - "Jupiter": 2. Andante cantabile - Live	Wolfgang Amadeus Mozart, Wiener Philharmoniker, Leonard Bernstein	Mozart: Symphonies Nos.35 "Haffner" & 41 "Jupiter","1
Il Garibaldi innamorato	Sergio Caputo	Ne Approfitto Per Fare Un Po' Di Musica
Walk Between Raindrops	Donald Fagen	The Nightfly
Birdland	Weather Report	Original Album Classics
La Stagione Dell'Amore - Remastered	Franco Battiato	Orizzonti Perduti (2008 Remastered Edition)
Mr. Blue Sky	Electric Light Orchestra	Out of the Blue
Kiss	Prince	Parade - Music from the Motion Picture Under the Cherry Moon
Il Barbiere di Siviglia (1983 Digital Remaster): Overture	Philharmonia Orchestra, Riccardo Muti	The Platinum Collection
La Caduta Di Atlante	Caparezza	Prisoner 709
Pendant que les champs brûlent	Niagara	Religion
Presto in C Major	Arnold Schoenberg, Quatuor Diotima	Schoenberg, Berg, Webern: Complete Works for String Quartet
Schoenberg: Verklärte Nacht, Op. 4: I. Grave	Arnold Schoenberg, Daniel Barenboim, Ruben Gonzalez, John Sharp, Li-Kuo Chang, Stephen Balderston, Charles Pikler, Joseph Golan, Chicago Symphony Orchestra	Schonberg : Verklärte Nacht, 5 Orchestral Pieces & Piano Works
Schumann : Piano Sonata No.1 in F sharp minor Op.11 : III Scherzo e intermezzo	Robert Schumann, Catherine Collard	Schumann : Piano Sonatas Nos 1 & 2, Papillons & 3 Romances (Apex)
Like a Rolling Stone - Live at the Isle of Wight, UK - August 1969	Bob Dylan	Self Portrait
Arabesque No. 1	Isao Tomita	Snowflakes Are Dancing
An der schönen blauen Donau, Op.314	Johann Strauss II, Berliner Philharmoniker, Herbert von Karajan	Strauss, J.: An der schönen blauen Donau (The Blue Danube)
Where Is My Mind?	Pixies	Surfer Rosa (Remastered)
Sweet Harmony (Original Mix)	Liquid	Sweet Harmony
Souvenir De Florence, Op. 70: IV. Allegro Vivace	Borodin Quartet, Mstislav Rostropovich, Genrikh Talalyan, Pyotr Ilyich Tchaikovsky	Tchaikovsky: Complete String Quartets / Souvenir De Florence
Boys Don't Cry	The Cure	Three Imaginary Boys
American Girl	Tom Petty and the Heartbreakers	Tom Petty & The Heartbreakers
La fille avec toi	Françoise Hardy	Tous les garçons et les filles
End Of The Line	Traveling Wilburys	The Traveling Wilburys, Vol. 1
Sinnerman - Felix Da Housecat's Heavenly House Mix	Nina Simone, Felix Da Housecat	Verve Remixed 2
Maybe Tomorrow	Stereophonics	You Gotta Go There To Come Back
La vie est belle	Indochine	13
The Wind Cries Mary	Jimi Hendrix	Are You Experienced
Little Wing	Jimi Hendrix	Axis: Bold As Love
Cello Suite No.1 In G Major, BWV 1007: 1. Prélude	Johann Sebastian Bach, Pierre Fournier	Bach, J.S.: The Cello Suites (2 CDs)
Suite For Cello Solo No.1 In G, BWV 1007: 2. Allemande	Johann Sebastian Bach, Pierre Fournier	Bach, J.S.: The Cello Suites (2 CDs)
We Have All the Time in the World	Louis Armstrong	The Best Of Louis Armstrong
Stressed Out	Twenty One Pilots	Blurryface
Samba de Orfeu	Luis Bonfa, Toots Thielemans	The Brasil Project Vol. II
Ramblin' Man	The Allman Brothers Band	Brothers And Sisters (Deluxe Edition)
Gershwin: Rapsody in Blue	Radio Hamburg Symphony Orchestra, George Gershwin, Ghunter von Herb	Classics for Love
September In the Rain	Dinah Washington	The Collection
Bluesette	Toots Thielemans	Columbia Jazz
Copacabana (At the Copa)	Barry Manilow	Dance Vault Mixes - Copacabana (At The Copa)
Serenade for String Orchestra in E major, Op. 22, II. Tempo di Valse	Antonín Dvořák, Petr Skvor, Prague Chamber Orchestra	Dvořák: Serenade for Strings, Czech Suite
Bewitched, Bothered, And Bewildered	Ella Fitzgerald	Ella Fitzgerald Sings The Rodgers And Hart Song Book
Night and Day	Frank Sinatra	The Essential Frank Sinatra
All By Myself	Céline Dion	Falling Into You
Careless Whisper	George Michael	The Final
I'll Be There for You - TV Version with Dialogue	The Rembrandts	Friends Soundtrack
The Girl From Ipanema	Antônio Carlos Jobim	The Girl From Ipanema
Eskimo - Live From Kiwi Di Piumazzo,Italy/194 / Edit	Francesco Guccini	Guccini Live Collection
What A Wonderful World	Louis Armstrong	Hello Louis - The Hit Years (1963-1969)
I'll Be There for You (Theme from "Friends')	The Rembrandts	I'll Be There For You (Theme From FRIENDS) / Snippets: Don't Hide Your Love / End Of The Beginning / Lovin' Me Insane / Drowning In Your Tears / This House Is Not A Home / What Will It Take [Digital 45]
Il Mondo	Jimmy Fontana	Il Mondo
Ti Sorrido Mentre Affogo	Caparezza	Il Sogno Eretico
If I Had You	Lucio Dalla, Doctor Dixie Jazz Band	JAZZ, primo amore dal 1960
Bossa Per Due	Nicola Conte	Jet Sounds
Blue in Green	Miles Davis	Kind Of Blue (Legacy Edition)
You Mean More To Me	Lionel Richie	Lionel Richie (Expanded Edition)
At Last - Single Version	Etta James	Love Songs
Wake Me up Before You Go-Go	Wham!	Make It Big
California Stars	Billy Bragg, Wilco	Mermaid Avenue
My Generation - Original Mono Version	The Who	My Generation (Remastered Mono Version)
Night And Day	Diana Krall	Night And Day
Bewitched - 2008 Remastered	Frank Sinatra	Nothing But The Best (Remastered)
La Gitane	Angelo DeBarre	Portrait Of Angelo
Thunderstruck	AC/DC	The Razors Edge
Eclisse twist	Mina	Ritratto di Mina: I singoli, Vol. 2
Signora Bovary - Remastered 2007	Francesco Guccini	Signora Bovary
Sous Le Ciel De Paris	Jacky Terrasson	Smile
I've Told Every Little Star	Linda Scott	Starlight Starbright
Night And Day - Remastered	Frank Sinatra	A Swingin' Affair! (Remastered)
Ai Du	Ali Farka Touré, Ry Cooder	Talking Timbuktu
Symphony No. 5 - Adagietto	Gustav Mahler	Time Code
The Way You Look Tonight	Frank Sinatra	Ultimate Sinatra
Jodellavitanonhocapitouncazzo	Caparezza	Verità Supposte
Night and Day	Cole Porter	What a Wonderful Jazz World
Dance Me to the End of Love	Bria Skonberg	With a Twist
I've Heard That Song Before	Harry James	Woody Allen et la musique
Heavy Metal Drummer	Wilco	Yankee Hotel Foxtrot
Diavolo rosso	Paolo Conte	Appunti Di Viaggio
Sneaking out the Back Door	Matt Bianco	The Best Of Matt Bianco
Concerto De Aranjuez	Rodrigo	The Best Spanish Guitar Music Of All Time
Safe From Harm - 2012 Mix/Master	Massive Attack	Blue Lines (2012 Mix/Master)
One Love - 2012 Mix/Master	Massive Attack	Blue Lines (2012 Mix/Master)
Violin Concerto In D, Op.77: 3. Allegro giocoso, ma non troppo vivace - Poco più presto - Live	Johannes Brahms, Anne-Sophie Mutter, New York Philharmonic, Kurt Masur	Brahms: Violin Concerto In D Major, Op. 77 / Schumann: Fantasy For Violin And Orchestra In C Major, Op. 131 (1997年 ライヴ・イン・ニューヨーク)
Cara	Lucio Dalla	Dalla
Futura	Lucio Dalla	Dalla
Do It Again	George Gershwin, B.G. DeSylva, Jane Russell, Lou Bring	The Essential George Gershwin
Do It Again/Soon	George Gershwin, André Previn	Gershwin: We got Rhythm - A Gershwin Songbook
Nessun Dolore	Giorgia	Giorgia/Incl. Extra Track
Holiday - Faded Ending	Green Day	Holiday
Where To Start	Lou Doillon	Lay Low
4/3/1943	Lucio Dalla	Lucio Dalla
Piano Sonata No.7 In C, K.309: 1. Allegro con spirito	Wolfgang Amadeus Mozart, Maria João Pires	Mozart: Piano Sonatas
Such a Shame	Talk Talk	Natural History - The Very Best Of Talk Talk
One Step Beyond	Madness	One Step Beyond...
Macaco	Paolo Conte	Paolo Conte
Eden	Paolo Conte	Parole D'Amore Scritte A Macchina
Happy Feet	Paolo Conte	Parole D'Amore Scritte A Macchina
"Nessun dorma!","Giacomo Puccini, Luciano Pavarotti, John Alldis Choir, Wandsworth School Boys Choir, London Philharmonic Orchestra, Zubin Mehta	Pavarotti Forever (2 CDs)	1
Pergolesi: Stabat Mater, P. 77: I. "Stabat Mater dolorosa","Giovanni Battista Pergolesi, Philippe Jaroussky, Julia Lezhneva, Diego Fasolis, I Barocchisti	Pergolesi: Stabat Mater, Laudate pueri & Confitebor	1
Bourée	Jethro Tull	Repeat - The Best of Jethro Tull, Vol. II
Concierto de Aranjuez: Adagio	Miles Davis	Sketches Of Spain 50th Anniversary (Legacy Edition)
Angiolino	Paolo Conte	Un Gelato Al Limon
Nocturnes (op. 32 Nr. 1 H-Dur / in B major)	Arthur Rubinstein	Berühmte Klavierkonzerte
Night And Day	Ella Fitzgerald	Ella Fitzgerald Sings The Cole Porter Songbook (Expanded Edition)
Fiume Sand Creek	Fabrizio De André	Fabrizio De André (Indiano)
Just Can't Get Enough - Live	Depeche Mode	Live in Berlin Soundtrack
Ba ba baciami piccina	Alberto Rabagliati	Quando la radio
Incontro - Remastered 2007	Francesco Guccini	Se Io Avessi Previsto Tutto Questo... La Strada, Gli Amici, Le Canzoni
La Vasca	Alex Britti	Alex Britti - Best Of
Nuova Ossessione	Subsonica	Amorematico
Cosi' Celeste	Zucchero	Best Of (Spec. Ed.-Italian)
Sultans Of Swing	Dire Straits	Dire Straits (Remastered)
Dalla pace del mare lontano	Sergio Cammariere	Io
Storia D'Amore	Adriano Celentano	Le Robe Che Ha Detto Adriano
Solo3min	Negramaro	Mentre tutto scorre (Deluxe Version)
La prima cosa bella	Nicola Di Bari	Nicola Di Bari
Insieme a te non ci sto più	Caterina Caselli	Qualcuno mi può giudicare
Our House	Madness	The Rise & Fall
Alta marea (Don't Dream It's Over)	Antonello Venditti	TuttoVenditti
Estate	Negramaro	Una storia semplice (Deluxe Edition)
Dune Mosse	Zucchero, Miles Davis	ZU & Co.
Donne	Zucchero, The Randy Jackson Band	Zucchero & The Randy Jackson Band
Aguaplano	Paolo Conte	Aguaplano
Paso doble	Paolo Conte	Aguaplano
Love Is In The Air	John Paul Young	Classic Hits
Light My Fire	The Doors	The Doors
Hotel California - Spanish Mix	Gipsy Kings	The Essential Gipsy Kings
Un gelato al limon	Paolo Conte	Extraordinary
Bamboléo	Gipsy Kings	Gipsy Kings
Eppur mi son scordato di te	Formula 3	Gli Anni 70
Il mio canto libero	Formula 3	I successi di Lucio Battisti
Ciao amore, ciao	Luigi Tenco	Luigi Tenco - I Miti
Comunque Dada	Caparezza	Museica
China Town	Caparezza	Museica
Teste Di Modì	Caparezza	Museica
Argenti Vive	Caparezza	Museica
Avanti, bionda	Paolo Conte	Paolo Conte
Bello e impossibile	Gianna Nannini	Profumo
Wishful Sinful	The Doors	The Soft Parade
Cosi' Celeste	Zucchero	Spiritodivino (Italian Version)
Rawnald Gregory Erickson the Second	STRFKR	Starfucker
Bimba se sapessi	Sergio Caputo	Un Sabato Italiano
Total Eclipse of the Heart	Bonnie Tyler	The Very Best Of Bonnie Tyler
Everybody's Talkin' - From "Midnight Cowboy","Harry Nilsson	Aerial Ballett	1
Per Elisa	Alice	Alice
Twist in My Sobriety	Tanita Tikaram	Ancient Heart
Medianoche	Inti-Illimani, Various Artists	Antología III (1989-1998 [Ita])
Ever Fallen In Love	Nouvelle Vague	Bande à Part
Wicked Game - Remastered	Chris Isaak	Best Of Chris Isaak
Gimme Some (Pt. 1)	Jimmy "Bo" Horne	The Best Of The TK Years 1975 - 1985
Soul Bossa Nova	Quincy Jones	Big Band Bossa Nova
O Superman	Laurie Anderson	Big Science
C'est la ouate - Radio Edit Original Version 1987	Caroline Loeb	C'est la ouate
Notte In Bovisa	Calibro 35	Calibro 35
L'appuntamento	Calibro 35	Calibro 35
Rewind	Vasco Rossi	Canzoni Per Me (Remastered 2017)
Cherchez le garçon	Taxi Girl	Chercher Le Garçon
Waiting For A Train	Flash and the Pan	Collection
I treni di tozeur - Remastered	Franco Battiato, Alice	Collezione Italiana
Don't Leave Me This Way (with Sarah Jane Morris)	The Communards, Sarah Jane Morris	Communards
Going Back to My Roots	Richie Havens	Connections
Friday On My Mind	The Easybeats	Easy
Mi Ami?	CCCP – Fedeli Alla Linea	Enjoy CCCP (2008 Remastered Edition)
Eye In The Sky	The Alan Parsons Project	Eye In The Sky (Expanded Edition)
Don't Think Twice, It's All Right	Bob Dylan	The Freewheelin' Bob Dylan
The King of Rock 'N' Roll	Prefab Sprout	From Langley Park To Memphis
Vivere	Vasco Rossi	Gli Spari Sopra (Remastered 2017)
Gravità	Frah Quintale	Gravità
Heart Of Glass - Special Mix	Blondie	Greatest Hits
Green Onions	Booker T. & the M.G.'s	Green Onions
I Put A Spell On You	Nina Simone	I Put A Spell On You
Feeling Good	Nina Simone	I Put A Spell On You
Take This Waltz - Paris Version	Leonard Cohen	I'm Your Man
Gnè, Gnè	Giorgio Conte	Il Contestorie
Wuthering Heights	Kate Bush	The Kick Inside
I'll Stand by You	Pretenders, Bob Clearmountain	Last Of The Independents
Sentimiento Nuevo - Live In Roma 2016	Franco Battiato, Alice	Live In Roma
Mellow Yellow	Donovan	Mellow Yellow
Wake Up And Make Love With Me	Ian Dury	New Boots And Panties (Deluxe Edition)
Malos Tiempos para la Lírica	Golpes Bajos	No Mires a los Ojos de la Gente
Silvano	Enzo Jannacci	No, Tu No
Non ho l'età (Per amarti)	Gigliola Cinquetti	Non ho l'eta'
La topolino Amaranto	Paolo Conte	Paolo Conte
Mala Vida	Mano Negra	Patchanka
Go Your Own Way - 2004 Remaster	Fleetwood Mac	Rumours
Ogni volta	Vasco Rossi	Sarà migliore
Première Gymnopédie	Erik Satie, Alexandre Tharaud	Satie: Avant-dernières pensées (Bonus Track Version)
Crucify Your Mind	Rodríguez	Searching For Sugar Man
Dormi e sogna	Avion Travel	Selezione 1990-2000
Apache	The Shadows	The Shadows' Greatest Hits
Uncertain Smile	The The	Soul Mining
This Must Be the Place (Naive Melody) - 2005 Remaster	Talking Heads	Speaking in Tongues (Deluxe Version)
Ti Amo	Phoenix	Ti Amo
Tombé du ciel	Jacques Higelin	Tombé du ciel
Eyes In The Back Of Your Head	STRFKR	Vault Vol. 1
Goodbye Kiss	Kasabian	Velociraptor!
Samba Landó	Inti-Illimani	Viva Italia
Avec le temps	Léo Ferré	50 Plus Belles Chansons
All Star	Smash Mouth	Astro Lounge
Dreadlock Holiday	10cc	Bloody Tourists
A Case of You	Joni Mitchell	Blue
Pasa la Vida - Remasterizada	Pata Negra	Blues de la Frontera (Remasterizada)
One Of These Things First	Nick Drake	Bryter Layter
For What It's Worth	Buffalo Springfield	Buffalo Springfield
Johnny And Mary	Robert Palmer	Clues
Scooby Snacks	Fun Lovin' Criminals	Come Find Yourself
We Have All the Time in the World	Fun Lovin' Criminals	Come Find Yourself
Us And Them - 2011 Remastered Version	Pink Floyd	The Dark Side Of The Moon (2011 Remastered Version)
Brain Damage - 2011 Remastered Version	Pink Floyd	The Dark Side Of The Moon (2011 Remastered Version)
People Have the Power	Patti Smith	Dream Of Life
Baby, I Love You	Ramones	End of the Century (Expanded 2005 Remaster)
The Rubberband Man - Version; Remastered	The Spinners	Essentials
Fiume Sand Creek	Fabrizio De André	Fabrizio De André Opere Complete
Un Altro Giorno É Andato - Live From Italy/2007 / Digital Remaster	Francesco Guccini	Fra La Via Emilia E Il West - Live
That Look You Give That Guy	Eels	Hombre Lobo
Da Funk	Daft Punk	Homework
Il est cinq heures, Paris s'éveille	Jacques Dutronc	Il est cinq heures
Jubel - Original Mix	Klingande	Jubel
Luci a San Siro	Roberto Vecchioni	L'uomo che si gioca il cielo a dadi
Golden Brown	The Stranglers	La Folie
The Circle Game	Joni Mitchell	Ladies Of The Canyon
Another Sunny Day	Belle & Sebastian	The Life Pursuit
Hmm Hmm Hmm	Serge Gainsbourg	Love On The Beat
Cry Me A River	Julie London	The Magic Of
I Need Some Sleep	Eels	Meet The EELS: Essential EELS 1996-2006 Vol. 1
Ti Sento	Matia Bazar	Melanchólia
Amor mio - 2001 Remastered Version	Mina	Mina
Yamore	Salif Keita, Cesaria Evora	Moffou
Serenade In G Major: Eine Kleine Nachtmusik, K. 525: I. Allegro	Wolfgang Amadeus Mozart, The English Concert, Andrew Manze	Mozart: Night Music
50mila	Nina Zilli, Giuliano Palma	Nina Zilli
Time to Pretend	MGMT	Oracular Spectacular
A Huge Evergrowing Pulsating Brain That Rules From The Centre Of The Ultraworld - Orbital Dance Mix	The Orb	The Orb - History Of The Future (Deluxe Edition)
Life Is A Minestrone	10cc	The Original Soundtrack
Give Peace A Chance	The Plastic Ono Band	Power To The People - The Hits
The Magnificent Seven - Remastered	The Clash	Sandinista! (Remastered)
A Short Love Story	Somewhere Anywhere, Claude Eman	A Short Love Story
I'm A Believer	Smash Mouth	Smash Mouth (International Version)
Sogna, Ragazzo, Sogna	Roberto Vecchioni	Sogna Ragazzo Sogna
Nothing'severgonnastandinmyway (Again)	Wilco	Summerteeth
ELT	Wilco	Summerteeth
Summer Teeth	Wilco	Summerteeth
You Don’t Get Me High Anymore	Phantogram	Three
Dans la Merco Benz - Radio Edit	Benjamin Biolay	Trash yéyé
Turn! Turn! Turn! (To Everything There Is a Season)	The Byrds	Turn! Turn! Turn!
Quando	Pino Daniele	Tutto Daniele
Un gelato al limon	Paolo Conte	Un Gelato Al Limon
Un homme et une femme - Instrumental	Francis Lai	Un homme et une femme (Original Motion Picture Soundtrack)
Samarcanda - 1997 Digital Remaster	Roberto Vecchioni	Vecchioni Studio Collection
Don't Dream It's Over	Crowded House	The Very Very Best Of Crowded House
Frederick	Patti Smith	Wave
Intro	The xx	xx
3e sexe	Indochine	3
Never Let Me Go (07-22-1954)	Johnny Ace	1951-1954
Curami	CCCP – Fedeli Alla Linea	Affinità - Divergenze Fra Il Compagno Togliatti E Noi Del Conseguimento Della Maggiore Età (2008 Remastered Edition)
Alive	Empire of the Sun	Alive
Paris	Après La Classe	Apres la Classe
Ricominciamo	Après La Classe	Apres la Classe
Goldberg Variations, BWV 988: Aria - Remastered	Johann Sebastian Bach, Glenn Gould	Bach: The Goldberg Variations, BWV 988 (1981 Gould Remaster)
Caroline Says, Pt. I	Lou Reed	Berlin: Live at St. Ann's Warehouse
Caroline Says, Pt. II	Lou Reed	Berlin: Live at St. Ann's Warehouse
Song 2 - 2012 Remaster	Blur	Blur [Special Edition]
Into My Arms - 2011 Remastered Version	Nick Cave & The Bad Seeds	The Boatman's Call (2011 Remastered Version)
The Chant	Artie Shaw	Bottle Rocket Short Film Soundtrack
Chan Chan	Buena Vista Social Club	Buena Vista Social Club
Spanish Stroll	Mink DeVille	Cabretta
These Days	Nico	Chelsea Girl
Ballade No. 4 in F Minor, Op. 52	Frédéric Chopin, Arthur Rubinstein	Chopin Piano Works
Unchained Melody	The Fleetwoods	Come Softly To Me: The Very Best Of The Fleetwoods
From Disco To Disco	Whirlpool Productions	Dense Music
Disco 2000	Pulp	Different Class / Deluxe Edition
Act II: Una furtiva lagrima ... Un solo instante	Gaetano Donizetti, Enrico Caruso	Enrico Caruso - The Complete Victor Recordings
Son Of A Gun	The Vaselines	Enter The Vaselines (Deluxe Edition)
Faith - Remastered	George Michael	Faith
Love My Way	The Psychedelic Furs	Forever Now
Only Happy When It Rains	Garbage	Garbage
Rhapsody In Blue - Live	George Gershwin, Leonard Bernstein, Los Angeles Philharmonic	Gershwin: Rhapsody In Blue; Prelude For Piano No. 2 / Bernstein: Symphonic Dances From "West Side Story","1
The Girl From Ipanema - Single Version	Stan Getz, João Gilberto, Astrud Gilberto, Antônio Carlos Jobim	Getz/Gilberto (Expanded Edition)
I'm Getting Sentimental Over You	Tommy Dorsey	Golden Greats - In the Frame: Tommy Dorsey
Hurdy Gurdy Man	Donovan	The Hurdy Gurdy Man
Would You...?	Touch & Go	I Find You Very Attractive
Life's A Beach	Touch & Go	I Find You Very Attractive
Mi piaccion le sbarbine	Skiantos	Kinotto
Floater (Too Much to Ask)	Bob Dylan	Love And Theft
Who	David Byrne, St. Vincent	Love This Giant
Carina - 2004 Remaster	Nicola Arigliano	Made In Italy
Ancora Tu - Original Mix	Róisín Murphy	Mi Senti
Sfiorivano le viole	Rino Gaetano	Mio Fratello E' Figlio Unico
Mozart: Don Giovanni, K. 527, Act 1: Sinfonia	Wolfgang Amadeus Mozart, Carlo Maria Giulini, Philharmonia Orchestra	Mozart : Don Giovanni
Le nozze di Figaro, K.492: Overture	Wolfgang Amadeus Mozart, Wiener Philharmoniker, Herbert von Karajan	Mozart: Le Nozze di Figaro
Piano Sonata No.12 In F, K.332: 2. Adagio	Wolfgang Amadeus Mozart, Maria João Pires	Mozart: Piano Sonatas K.309, K.332 & K.570
Verdi: La traviata, Act 1: "Sempre libera" (Violetta, Alfredo)	Giuseppe Verdi, Maria Callas, Gabriele Santini, Orchestra Sinfonica della RAI	The New Sound of Maria Callas
Night and Day	Everything But The Girl	Night and Day
Le sud	Nino Ferrer	Nino Kids
Oh, Pretty Woman	Roy Orbison	Oh, Pretty Woman
Kids	MGMT	Oracular Spectacular
Isobel	Björk	Post
Just Like Honey	The Jesus and Mary Chain	Psychocandy
More Than This	Roxy Music	Roxy Music Collection
Piano sonata in A Major, D. 959: II. Andantino	Franz Schubert, Paul Lewis	Schubert: The Late Piano Sonatas
Winterreise D.911: Erste Abteilung: Der Lindenbaum	Franz Schubert, Werner Güra, Christoph Berner	Schubert: Winterreise D.911
Noi Non Ci Saremo - Remastered 2007	Francesco Guccini	Se Io Avessi Previsto Tutto Questo... La Strada, Gli Amici, Le Canzoni
Lontano Lontano	Francesco Guccini	Se Io Avessi Previsto Tutto Questo... La Strada, Gli Amici, Le Canzoni
Don't Let Me Be Misunderstood	The Animals	The Singles Plus
Bella Ciao	Chumbawamba	A Singsong and a Scrap
Body And Soul	Benny Goodman Trio, Benny Goodman	Small Groups: 1941-1945
Good Vibrations	Brian Wilson	Smile
So Long, Marianne	Leonard Cohen	Songs Of Leonard Cohen
Stop	Sam Brown, Pete Brown	Stop!
Città vuota (It's a lonely town)	Mina	Studio Uno
One Week	Barenaked Ladies	Stunt
Toda Joia Toda Beleza - Remastered	Roy Paci & Aretuska, Manu Chao	Suonoglobal
Piano Concerto No. 1 in B-Flat Minor, Op. 23, TH 55: 1. Allegro non troppo e molto maestoso - Allegro con spirito - Live	Pyotr Ilyich Tchaikovsky, Martha Argerich, Berliner Philharmoniker, Claudio Abbado	Tchaikovsky: Piano Concerto No.1; The Nutcracker Suite
If I Ever Feel Better	Phoenix	United
Pale Blue Eyes	The Velvet Underground	The Velvet Underground
After Hours	The Velvet Underground	The Velvet Underground
Femme Fatale	The Velvet Underground, Nico	The Velvet Underground & Nico 45th Anniversary (Super Deluxe Edition)
I'll Be Your Mirror	The Velvet Underground, Nico	The Velvet Underground & Nico 45th Anniversary (Super Deluxe Edition)
Verdi: Aida, Act 1: "Se quel guerrier io fossi!" (Radamès)	Giuseppe Verdi, Riccardo Muti, New Philharmonia Orchestra	Verdi: Aida
La traviata: Act I: Un di, felice, eterea (Alfredo, Violetta)	Giuseppe Verdi, Maria Callas, Cristina Trevi, Edna Pattoni, Giuseppe Di Stefano, Piero Campolonghi, Francesco Tortolero, Gilberto Cerda, Ignacio Ruffino, Francisco Alonso, Palacio de Bellas Artes Chorus, Palacio de Bellas Artes Orchestra, Humberto Mugnai	Verdi: La traviata
Andrea Chenier (1986 - Remaster): La mamma morta	Umberto Giordano, Maria Callas, Tullio Serafin, Philharmonia Orchestra	The Very Best of Maria Callas
De Do Do Do, De Da Da Da	The Police	The Very Best Of Sting And The Police
Alturas	Inti-Illimani	Viva Italia
Tannhäuser, WWV 70: Overture	Richard Wagner, Wiener Philharmoniker, Herbert von Karajan	Wagner: Tannhäuser Overture; Siegfried-Idyll; Tristan und Isolde
Demasiado Corazon (Too Much Heart)	Mink DeVille	Where Angels Fear To Tread
Friday I'm In Love	The Cure	Wish
1901	Phoenix	Wolfgang Amadeus Phoenix
My Daddy (Flies a Ship in the Sky)	Woody Guthrie	Woody At 100: The Woody Guthrie Centennial Collection
Young Americans - 2007 Remaster	David Bowie	Young Americans
Lookin' for a Love - 2016 Remaster	Neil Young, Crazy Horse	Zuma
Through My Sails - 2016 Remaster	Neil Young, Crazy Horse	Zuma
Starálfur	Sigur Rós	Ágætis Byrjun
Down	Marian Hill	ACT ONE
Aqualung	Jethro Tull	Aqualung (Special Edition)
Wond'ring Aloud	Jethro Tull	Aqualung (Special Edition)
J'ai fréquenté la beauté	Jean-Louis Murat	Babel
Girl, You'll Be A Woman Soon	Neil Diamond	The Bang Years 1966-1968 (The 23 Original Mono Recordings)
Me So' Mbriacato	Mannarino	Bar Della Rabbia
Brand New Key	Melanie	Beautiful People: The Greatest Hits of Melanie
Massenet: Thaïs: Méditation	Jules Massenet, Anne-Sophie Mutter, Herbert von Karajan, Berliner Philharmoniker	Best of Anne-Sophie Mutter
A Whiter Shade Of Pale	Procol Harum	The Big Chill 15th Anniversary
Money For Nothing	Dire Straits	Brothers In Arms (Remastered)
Walk Of Life	Dire Straits	Brothers In Arms (Remastered)
Se io fossi un angelo - Live	Lucio Dalla	Dallamericaruso
Futura - Live	Lucio Dalla	Dallamericaruso
Brazil	Django Reinhardt	Django Reinhardt: Legendary Recordings
(Sittin' On) the Dock of the Bay - Mono	Otis Redding	The Dock of the Bay (Mono)
Take It Easy - 2013 Remaster	Eagles	Eagles (2013 Remaster)
Je ne veux pas travailler	Sole Gimenez	El cielo de Paris
Per qualche dollaro in più	Ennio Morricone	Ennio Morricone Gold Edition - 50 Movie Themes Hits
Where Have All The Flowers Gone	Marlene Dietrich	The Essential Marlene Dietrich
Battez-vous	Brigitte	Et vous, tu m'aimes ?
Reflections Of My Life - Original recording	Marmalade	Fine Cuts - The Best Of Marmalade (Original Recordings)
Wake Up	Arcade Fire	Funeral
Europa (Earth's Cry, Heaven's Smile)	Gato Barbieri	Gato Barbieri: Finest Hour
Désolé pour hier soir	Tryo	Grain De Sable
Hotel California - 2013 Remaster	Eagles	Hotel California (2013 Remaster)
Altrove	Morgan	I grandi successi
Losing My Religion	R.E.M.	In Time: The Best Of R.E.M. 1988-2003
Eminence Front	The Who	It's Hard (Remastered)
Maybe	Janis Joplin	Janis Joplin: The Woodstock Experience
L'aventurier	Indochine	L'aventurier
Trois nuits par semaine	Indochine	Le Birthday album
The Guns of Brixton - Remastered	The Clash	London Calling (Remastered)
Anidride solforosa	Lucio Dalla	Lucio Dalla
Tiny Dancer	Elton John	Madman Across The Water
Contre l'amour	Jean-Louis Murat, Isabelle Huppert	Mme Deshoulieres
Love Hurts - Single Edit	Nazareth	The Naz Box
Time In a Bottle	Jim Croce	The Original Albums...Plus
Free Bird	Lynyrd Skynyrd	(Pronounced 'Leh-'Nérd 'Skin-'Nérd) [Expanded Edition]
Personality Crisis	New York Dolls	Rock 'N Roll
Schubert : Auf dem Wasser zu singen D774	Franz Schubert, Barbara Bonney	Schubert : Lieder
Farewell	Francesco Guccini	Se Io Avessi Previsto Tutto Questo... La Strada, Gli Amici, Le Canzoni
Paint It Black	The Rolling Stones	Singles 1965-1967
Enjoy the Silence	Depeche Mode	The Singles 86-98
Space Oddity - 1999 Remaster	David Bowie	Space Oddity (1999 Remaster)
Impressioni di settembre	Premiata Forneria Marconi	Storia Di Un Minuto
È festa	Premiata Forneria Marconi	Storia Di Un Minuto
La carrozza di Hans	Premiata Forneria Marconi	Storia Di Un Minuto
Le tourbillon	Jeanne Moreau	Succès Et Confidences
It's Too Late	Carole King	Tapestry
Tom's Diner	Suzanne Vega, DNA	Total Hits Vol. 2
Una storia disonesta	Stefano Rosso	Una Storia Disonesta
Too Young	Phoenix	United
Won't Get Fooled Again - Remix	The Who	Who's Next (Remastered)
Wish You Were Here - 2011 Remastered Version	Pink Floyd	Wish You Were Here (2011 Remastered Version)
Come	Jain	Zanaka (Deluxe)
Non Voglio Ritrovare Il Tuo Nome	Afterhours	Folfiri o Folfox
Trinity: titoli	Annibale E I Cantori Moderni	Lo chiamavano Trinità (Original Soundtrack)
The House of the Rising Sun	The Animals	Most Of The Animals
En Bleu Marine	Paolo Conte	Amazing Game - Instrumental Music
La porte bonheur	Oxmo Puccino, Ibrahim Maalouf	Au pays d'Alice...
She Smiled Sweetly	The Rolling Stones	Between The Buttons (Remastered)
These Boots Are Made For Walkin'	Nancy Sinatra	Boots
Dream A Little Dream Of Me - Album Version With Introduction	The Mamas & The Papas	California Dreamin' - The Best of The Mamas & The Papas
Completamente	Thegiornalisti	Completamente Sold Out
Chanson sur ma drôle de vie	Véronique Sanson	De l'autre côté de mon rêve
Nel letto di Lucia	Rino Gaetano	...e cantava le canzoni
Dedicated To The One I Love	The Mamas & The Papas	A Gathering Of Flowers: The Anthology Of The Mamas & The Papas
Angie - Remastered 2009	The Rolling Stones	Goats Head Soup (Remastered 2009)
Monday, Monday - Single Version	The Mamas & The Papas	If You Can Believe Your Eyes And Ears
California Dreamin'	The Mamas & The Papas	If You Can Believe Your Eyes And Ears
Reality	Vladimir Cosma, Richard Sanderson	La boum (Bande originale du film de Claude Pinoteau)
Where Do You Go To (My Lovely) [Re-Recorded]	Peter Sarstedt	The Lost Album
Madeleine	Paolo Conte	Paris Milonga
Boogie	Paolo Conte	Paris Milonga
Parigi	Paolo Conte	Paris Milonga
Alone	Selah Sue	Reason
Wild Horses	The Rolling Stones	The Rolling Stones Singles Box Set (1971-2006) [Sampler]
Cigarettes And Coffee	Scialpi	Scialpi
This World	Selah Sue	Selah Sue
Tout le bonheur du monde - Live	Sinsémilia	Sinsemilia "The Reggae Addicts' Live","1
Wigwam	Totta Näslund	Totta's Basement Tapes: Down In The Flood - 11 Songs By Bob Dylan
Girls Just Wanna Have Fun	Cyndi Lauper	80s 100 Hits
Aline	Christophe	Aline
One Way Or Another	Blondie	Atomic/Atomix
Vita Sociale	Canova	Avete ragione tutti
Expo	Canova	Avete ragione tutti
Manzarek	Canova	Avete ragione tutti
Portovenere	Canova	Avete ragione tutti
Beautiful Soul	Jesse McCartney	Beautiful Soul
Django's Tiger	Django Reinhardt	The Best Of Django Reinhardt
Born This Way	Lady Gaga	Born This Way (International Special Edition Version)
Canadian Sunset	Gene Ammons	Boss Tenor (Rudy Van Gelder Remaster)
Il pugile	Brunori Sas	Brunori Sas, Vol. 1
Italian Dandy	Brunori Sas	Brunori Sas, Vol. 1
Canzone	Lucio Dalla	Canzoni
La verità	Brunori Sas	A casa tutto bene
Comment te dire adieu - It Hurts to Say Goodbye	Françoise Hardy	Comment te dire adieu ?
Questi posti davanti al mare	Ivano Fossati	Contemporaneo
Stand by Me	Ben E. King	Don't Play That Song (Mono)
Non, je ne regrette rien	Édith Piaf	Edith Piaf - The Best Of
September	Earth, Wind & Fire	The Eternal Dance
Quello che le donne non dicono	Fiorella Mannoia	Fiorella Mannoia - I Miti
Amarsi male	Lo Stato Sociale	Garrincha Mixtape vol. 5 – Gran volata
I Got A Name - Stereo Version	Jim Croce	Greatest
Boogie Wonderland	Earth, Wind & Fire, The Emotions	I Am
I Don't Want to Miss a Thing - From the Touchstone film, "Armageddon","Aerosmith	I Don't Want To Miss A Thing	1
Respect	Aretha Franklin	I Never Loved a Man the Way I Love You
Kurt Cobain	Brunori Sas	Il Cammino di Santiago in taxi, Vol. 3
Il Ragazzo Della Via Gluck - Remastered	Adriano Celentano	Il Ragazzo Della Via Gluck (2012 Remaster)
Una storia sbagliata	Fabrizio De André	In Direzione Ostinata e Contraria
La fleur aux dents	Joe Dassin	Joe Dassin Éternel...
Gas Gas	Goran Bregović	Karmen (With A Happy End)
Le Premier jour du reste de ta vie - Remasterisé en 2015	Étienne Daho	L'homme qui marche - Best of Etienne Daho
Douliou-douliou Saint-Tropez - From "Le Gendarme de Saint-Tropez","Geneviève Grad, Raymond Lefèvre	L'intégrale des Gendarmes (Bande originale des films)	1
Fais-moi mal Johnny	Boris Vian, Magali Noël	Le déserteur
This Time Tomorrow - Stereo;2014 Remastered Version	The Kinks	Lola vs. Powerman and the Moneygoround, Pt. One + Percy
Chissà se lo sai	Lucio Dalla	Lucio Dalla
Lust For Life	Iggy Pop	Lust For Life
Rhapsody in Blue	Gary Graffman	Manhattan: Original Motion Picture Soundtrack
Narcotic - Long Version	Liquido	Narcotic
Nessuno mi può giudicare	Caterina Caselli	Nessuno Mi Puo' Giudicare
Amore con riserva	Brunori Sas	O.S.T. E' nata una star?
Take Five	Dave Brubeck	On Time
La mer	Charles Trenet	Platinum
L'assenzio ( the Power of Nothing)	Bluvertigo	Pop Tools (Alcune Fasi e Forme d'Onda)
Le ciel dans une chambre	Carla Bruni	Quelqu'un M'a Dit
Best of My Love	The Emotions	Rejoice
Rocket Man (I Think It's Going To Be A Long Long Time)	Elton John	Rocket Man (Deluxe Edition)
Act II: Barcarolle: Belle nuit	Jacques Offenbach, Anton Guadagno	Romantic Caballé
Di sole e d'azzurro	Giorgia	Spirito Libero
This Is What You Came For	Calvin Harris, Rihanna	This Is What You Came For
Salirò	Daniele Silvestri	Unò-Dué
Somethin' Stupid	Frank Sinatra, Nancy Sinatra	The World We Knew
Canto a la rebelión	Ska-P	99%
Max	Paolo Conte	Aguaplano
Colpa d'Alfredo	Vasco Rossi	Colpa D' Alfredo
A mano a mano - Live	Rino Gaetano	E Cantavo Le Canzoni
Onda su onda	Paolo Conte	Extraordinary
Dancing	Paolo Conte	Extraordinary
Tua cugina prima - Tutti a Venezia	Paolo Conte	Extraordinary
Le Chic et le charme	Paolo Conte	Extraordinary
Less is Moi	Stuart Duncan, Chris Thile, Edgar Meyer, Yo-Yo Ma	The Goat Rodeo Sessions
Lontano dagli occhi	Sergio Endrigo	I Grandi Successi: Sergio Endrigo
Comprami	Viola Valentino	Le più belle canzoni di Viola Valentino
Gli impermeabili	Paolo Conte	Paolo Conte
Come mi vuoi?	Paolo Conte	Paolo Conte
Julep	Punch Brothers	The Phosphorescent Blues
Cruisin	Sioen	See You Naked
Girl, You'll Be a Woman Soon	Urge Overkill	Stull
All The Things She Said - Original Album Version (Edited)	t.A.T.u.	t.A.T.u. - The Best
Ya Rayah	Rachid Taha	Tekitoi?
Dragostea Din Tei - Original Romanian Version	O-Zone	Time 25th Anniversary
Senza Un Perché	Nada	Tutto L'amore Che Mi Manca
Fuga all'inglese	Paolo Conte	Wonderful
Sogno di liberta	Mikis Theodorakis, Milva	1925 – 2015: 90 Years Mikis Theodorakis
Charlie fa surf	Baustelle	Amen
Luglio, agosto, settembre (nero)	Area	Arbeit Macht Frei
Questo nostro grande amore	I Cani	Aurora
Suspicious Minds	Elvis Presley	Back In Memphis
Mackie Messer - Moritat	Domenico Modugno	Best of Domenico Modugno
Can't Help Falling in Love	Elvis Presley	Blue Hawaii
Oggi Sono Io	Mina	The Collection 3.0
Gioia e rivoluzione	Area	Crac!
Un giorno credi	Edoardo Bennato	Edoardo Bennato
Sono solo canzonette	Edoardo Bennato	Edoardo Bennato
Il gatto e la volpe	Edoardo Bennato	Edoardo Bennato
È stata tua la colpa	Edoardo Bennato	Edoardo Bennato
Ancora	Eduardo De Crescenzo	Eduardo De Crescenzo - All The Best
A Little Less Conversation - JXL Radio Edit Remix	Elvis Presley, JXL	Elvis 75 - Good Rockin' Tonight
Preghiera in Gennaio	Fabrizio De André	Fabrizio De André Opere Complete
Spiritual	Fabrizio De André	Fabrizio De André Opere Complete
Tre madri	Fabrizio De André	Fabrizio De André Opere Complete
Canzone dell'amore perduto	Fabrizio De André	Fabrizio De André Opere Complete
Eskimo - Live From Italy/2007 / Digital Remaster	Francesco Guccini	Fra La Via Emilia E Il West - Live
Il cielo in una stanza	Gino Paoli	Gino Paoli
Mack the Knife	Louis Armstrong	I Like Jazz: The Essence Of Louis Armstrong
Hipsteria	I Cani	Il Sorprendente Album D'Esordio De I Cani
Perdona E Dimentica	I Cani	Il Sorprendente Album D'Esordio De I Cani
Wes Anderson	I Cani	Il Sorprendente Album D'Esordio De I Cani
Bang Bang	Dalida	L'Intégrale Des Enregistrements Orlando
City Of Stars / May Finally Come True	Justin Hurwitz, Ryan Gosling, Emma Stone	La La Land (Original Motion Picture Score)
Centro Di Gravità Permanente - Remastered	Franco Battiato	La Voce Del Padrone (2008 Remastered Edition)
Milano	Calcutta 	Mainstream (Deluxe Edition)
Frosinone	Calcutta 	Mainstream (Deluxe Edition)
O cielo ce manna 'sti ccose	MiNa	Napoli secondo estratto
Natural Blues - Coyu Remix	Moby, Coyu	Natural Blues (Coyu Remix)
Eskimo - Remaster 1996	Francesco Guccini	The Platinum Collection
Natural Blues	Moby	Play & Play: B Sides
Che vuole questa musica stasera	Armando Trovajoli	Profumo di donna
Salviamo Il Salvabile	Edoardo Bennato	Salviamo il salvabile
Culodritto - Remastered 2007	Francesco Guccini	Signora Bovary
Ookpik Waltz	Chris Thile, Michael Daves	Sleep With One Eye Open
Canzone Delle Osterie Di Fuori Porta - Remastered 2007	Francesco Guccini	Stanze Di Vita Quotidiana
Canzone Della Triste Rinuncia - 2007 Digital Remaster	Francesco Guccini	Stanze Di Vita Quotidiana
Canzone Delle Ragazze Che Se Ne Vanno - 2007 Digital Remaster	Francesco Guccini	Stanze Di Vita Quotidiana
Canzone Delle Situazioni Differenti - 2007 Digital Remaster	Francesco Guccini	Stanze Di Vita Quotidiana
Zorba the Greek: Zorba's Dance	Mikis Theodorakis	Zorba the Greek (Remastered)
Trois nuits par semaine	Indochine	3
Se telefonando	Mina	4 anni di successi
Take A Chance On Me	ABBA	The Album
Spiegel im spiegel	Arvo Pärt, Angèle Dubeau, La Pietà	Arvo Pärt: Portrait
Il posto più freddo	I Cani	Aurora
Una Carezza In Un Pugno - Remastered	Adriano Celentano	Azzurro (2011 Remaster)
Bangarang (feat. Sirah)	Skrillex, Sirah	Bangarang EP
Yes Sir, I Can Boogie	Baccara	Best Of
Lowlife	That Poppy	Bubblebath
American Kids	That Poppy	Bubblebath
Le temps de l'amour (Remastered)	Françoise Hardy	Canciones de Amor Vol.8: Francia
Luka	Suzanne Vega	Close Up, Vol. 2 - People & Places
Don't Know Why	Norah Jones	Come Away With Me
Last Good Day Of The Year	Cousteau	Cousteau
Muddy Waters	LP	Death Valley - Ep
There's More To Life Than This - Live At The Milk Bar Toilets	Björk	Debut
Le vent nous portera	Noir Désir	Des Visages Des Figures
Door To The Cosmos	Sun Ra	DJ-Kicks (Motor City Drum Ensemble) [Mixed Tracks]
Seven Nation Army	The White Stripes	Elephant
Where Is The Love?	The Black Eyed Peas	Elephunk (International Version)
Amico Fragile - Live remastered 2007	Fabrizio De André	Fabrizio De Andrè e PFM - Il concerto1978/1979
Freak On a Leash	Korn	Follow The Leader
Night Like This	LP	Forever For Now
Into The Wild	LP	Forever For Now
Vedi Cara - Live From Italy/2007 / Digital Remaster	Francesco Guccini	Fra La Via Emilia E Il West - Live
Take Me Out	Franz Ferdinand	Franz Ferdinand
Go Do	Jónsi	Go
Venezia - Live From Italy/1984 / Edit	Francesco Guccini	Guccini Live Collection
Under Pressure - Remastered	Queen, David Bowie	Hot Space (2011 Remaster)
Take on Me	a-ha	Hunting High And Low
La valse à mille temps	Jacques Brel	Infiniment
Vesoul	Jacques Brel	Infiniment
Shoots and Ladders	Korn	Korn
Io, te e Carlo Marx	Lo Stato Sociale	L'Italia peggiore
Inevitabilmente (Lettera Dal Carcere)	Fiorella Mannoia	Le Mie Canzoni
La nuit n'en finit plus	Petula Clark	Les Plus Grands Succès De Petula Clark
I Loves You Porgy	Nina Simone	Little Girl Blue (Remastered 2013)
Senza un perché	Nada	Live Stazione Birra
Lost on You	LP	Lost on You
Other People	LP	Lost on You
I Don't Like Mondays	The Boomtown Rats	Loudmouth - The Best Of Bob Geldof & The Boomtown Rats
Modern Drift	Efterklang	Magic Chairs
The Model - 2009 Remastered Version	Kraftwerk	The Man Machine (2009 Remastered Version)
La Vita Com'è	Max Gazzé	Maximilian
Ti Sembra Normale	Max Gazzé	Maximilian
Jungle Drum	Emilíana Torrini	Me And Armini
Teardrop	Massive Attack	Mezzanine
Amiga Da Minha Mulher	Seu Jorge	Músicas Para Churrasco (Vol. I)
Amore Disperato - 2004 Remaster	Nada	Nada: Solo Grandi Successi
Give Me One Reason	Tracy Chapman	New Beginning
Non È Per Sempre	Afterhours	Non È Per Sempre
Sparring Partner	Paolo Conte	Paolo Conte
Sotto le stelle del jazz	Paolo Conte	Paolo Conte
Mes emmerdes	Charles Aznavour	Platinum Charles Aznavour
Hyperballad	Björk	Post
It's Oh So Quiet	Björk	Post
Tom's Diner - 7" Version	DNA, Suzanne Vega	RetroSpective: The Best Of Suzanne Vega
Argentina - Remastered 2007	Francesco Guccini	Se Io Avessi Previsto Tutto Questo... La Strada, Gli Amici, Le Canzoni
She's Leaving Home - Remastered	The Beatles	Sgt. Pepper's Lonely Hearts Club Band (Remastered)
Don't Wanna Fight	Alabama Shakes	Sound & Color
I Feel It Coming	The Weeknd, Daft Punk	Starboy
Masollan	Balmorhea	Stranger
Fake Fealty	Balmorhea	Stranger
Ne me quitte pas	Jacques Brel	Suivre L'Etoile
Ulysses	Franz Ferdinand	Tonight
No You Girls	Franz Ferdinand	Tonight
Tour De France - 2009 Remaster	Kraftwerk	Tour De France (2009 Remastered Version)
Fast Car	Tracy Chapman	Tracy Chapman
And We Danced (feat. Ziggy Stardust)	Macklemore	The Unplanned Mixtape
Madama Butterfly (1987 - Remaster), Act II: Un bel di vedremo	Giacomo Puccini, Maria Callas, Orchestra Del Teatro Alla Scala, Milano, Herbert von Karajan, Orchestra Del Teatro Alla Scala Di Milan	The Very Best of Maria Callas
Samson et Dalila (1987 Digital Remaster): Mon coeur s'ouvre à ta voix.	Camille Saint-Saëns, Maria Callas, Georges Prêtre, Choeurs et Orchestre National de la Radiodiffusion, The Orchestra National De La Radiodiffusion Francaise, French National Radio Orchestra	The Very Best of Maria Callas
We Bought A Zoo	Jónsi	We Bought A Zoo (Motion Picture Soundtrack)
Do You Want To	Franz Ferdinand	You Could Have It So Much Better
Nature Boy	Nat King Cole	The Nat King Cole Story
Keep Your Name	Dirty Projectors	Dirty Projectors
